-M-----Bo-oM---B-?----MM?-?----EEo-M-B-EX---o-X--------E--o----oM-------X-------Eo-?--?-XoEo--------BE-MX----B-------X-------M------ME?--------M-BE---------oXBM-EE------M---M-M--XM-----M--?BME?E-Bo---
----o--o?---B--E--?-o----B---?----ME---E-------B--o--Mo--EBX-EM---?BX--------XE--EM--EB-B-----X--E---BE?----o-o?---B--M--?--??-EB??---------M-----E--o-E--M--M--B-----E------------X---------XE-------E-
----?-?-o-E-X-B-o-----------B-X--X-----MX---?-------------o-o?------??----o---------B?--o-----M-----B-MX-------M--ME----------??---?oB----X-----ME?--EX--o---X-----E-------X-M-E--o--Xo---B??M--?-BMBBX-
----X-?-?M-X------BB------X-------B?----------B-?----X-oX-o---M--X--E-B---?-E--?--B--o------M-----E---E------Mo-XM-EE----?-EoEo-----X--B-----------o--E-------------oBoEX-----oE--------B-----X----B--?-
--E--E--------M--X------o---MMX-B--B?--o-B----E-------------------Bo--o-?---B--X-X--M-B-XB?--o-??-EB--E?MB-o-o---?---X-oM-E---X-----------X-E-----ME---M------------------?-M----o----------------Xo?-o-
---X------E--------Xo--M---------M---o?--------o---E--o----X-----B----o--o-?----M-B-Xo--MM-B-----BB-oEXo--X-----B---M----o?----M---------oo-MXMMB--o??-oX-----X---------?B--EoB---oMB-E---E---M-----o---
-X-o-B--X-----E-ME-----------?------o---------o?------B-BB---Boo---E--B----?o-----------X--oo?---B-M----?---EoB-?-B-M-?X---------B----M--M-?X--o-X------XB---M-----B--?-----X-X?----B------------X-o?XB-
-----?----?o?----?------?--------X---X---X--MX-M-M-B--M-----o--------BM-----X--BM------M--o--XBB---oX-o-----XB-B---?-E-----BM?M?---?ME----B-----M-X-BM-M--ME?o-?-----E-B?--o-----M-M---B--M-E--------o-v
--X--X-B--X--------X--X-X----XX--E-----?-M----E-X-M-o--B---o-----X-------?E---E--X--ME------?--X-------M-BMo----B-B--E---M-M??-------M-M-M---?--E---------E-E--------M-??-B---M-X---B------o---------?Ef
-M----?----------o-----o-o-?-?-BE-?---?o-?--o--o-----E-X-----B-X--o-M-X-B-----o-------M-?--E---o?-EX--M----X----?-M---------E-E-----MX-B--o---o------ME-X--?-ME----E-------oX-M-o-X--------E--XE?------f
-----M-M-MME--M--?-B-o-X-----B-X------XX---EEX?-M--E-o-------B-----Eo--o---X---Eo---XME--o-o---EME--ooB---?-X-?--M-M-o?--B------?----?-E--BM----X----XXM-----?----------B--M-------E-M-------?---o--M-?f
-----E---M-X?----------------o--M---X--?-XB---X-o---E-X-------E-o-MB---o----M----M-EM--X-M-MM-M?-E-B-X---------M--B------------------B--X-MX--Xo--M-MB--M---M---M----B-------------X--B-M-E-----?-----of
----o?-?-----X-o----B----?-B-M-M-MX-o-B------o----------X-------------EBo-M-M?Eo---?-X------------X---B-M---E--EE------E--E----?--M----?-Xo-B---o--------XM-------E-M?----E---?-------?---oBoMM-E-?-Xo-f
-?o---X---o--?--B--X---B--X--E-----?M-----oB-------M-------B-X---------?-X-BE-?-B-----------BX--oBE--E-E---XM--M--X--o---X---M----E----?B-E?-------?----?-----oX--M-?B-X-----?-----B----------E--MXXM--f
m--Mo--TB--M?-T-M-E-------TM----E--------T--o-----X-B-o--?-??B-------o---E-------?--------B---o--X-M---XEo-EM---?MTo---TooM?---?---?o-MBE--ME--?-MET-E------o-------oME--?-----?o----M--X---------BM-T-X
XXEXXX?|?XXXXE|XBoXXXXXXXo|XXoXXXXXXMXEXX|XXEXXXXXXXXXoMXXXMBXXEXXXBMXXXX?XXXXX?XoXXXMXXXEXXoEXXXXXXXMXX?BXXEXEXXX|EXXX|XoXEXXXXX?XXXXMoXXXX?XXXXXX|XXXXXXBEXXBXEBXBXXXXXXXoXMXoXoXXXXXXoXoXXXXMXXXX?|XX
