------X?-------M?---BB----E-B?-------------oXMX-Xo------E--?-XB------?X--------MoX----o---E-X--M-X-o-B-M-oM-?-B-B-X-------X-----E-----o-------E--M------o-X-X----?E?----o--EB-X----?----E-----------Mo?-
---?---X---------?-----X-oX---?X------oM---o-X?M-X--o---B-EX--X-M----o---?X------------E?----X--X-MBB---XE------X--oM------X-o--------o---B-------B---X-o-M-B-?---------B-------M-B-M-------M----?XX--B-
-?-EB-------MM----X---------M-B----M----MX--------X--?B-X--oM----B--?E--------BXB-XB---?---?--X---X-------MM-M--XE--oEo-----------B---MB-?-?-------E--o----X-o-----------XB----E-B?-----o---E-XM---o----
-?----E-o?-----B---B------M?-X-----B--M-------------EE----B--X---M------?-o-E--B---B---M--B--------?---oXB-oM----------X---B---M--o------B-Bo----M--EM--------------------X-X-X--XM---o--BB?E--Bo-------
-MX-?---B---o?-----o-EE---BBoE------B-----MM-BoX-o--X-----------M?---?------X---M------E----X-----B-----------M---?-o-E--M-----B--oB-X---------oE-----oBX-----M---B-?-oXX--B-X-?o--------XX------oo-B-B-
----Xo-E--ME-?-------B?-??----XE--oB-M--X?E-------------------?-E-?----M----B--oE-?--oE----M-----EoBE----o----B--oo--X-------B--oX-----?-----B-----MXEX---B---B-B-B-M--BEB--E-X----B--B-----M----X------
-M-E-B-------M-----B--B--E---X--o---X--XoB------------oE-?---M--M----E---------M-----B----?------------B-----M-M------X----o---o-XX----?----Bo-Xo-BE-------M--E--?-X--------?--M-------EXE--------------
-?---B---?----XB-E--?o----?-X--M------?--E-----M-oX----------M----o-MB--------X-M-----oMM-------o-EE-------EMo----M?-o-X------------X-E-X--?B---o-oX-X--o--X--E?------?--E--M---BX----?------------B-XXv
-ooo-----E---X--XBM---B--Bo-----BM--oB--E-o---B----B-BB----E-----B--E----?M--B-?-BB-M-------o-----o---X-oE-?-??E------X------E--B?-------B-M------X-----o?--M?-X-----?----o----?-B----M---Mo-o?--X-?---f
--o-----X-M----??B---------------?--?----?-X--E-M-----XB?----M?EM---------XEX--EB-----B--XE--B--?--XoXooBEM-------------B-EXB------E--?---o---oM-M-?X--B----o----BB-?M--EB----oE----E---X---BX---?-----f
-?---------------?X-E-X------E-MB---Mo-E--B--?----E--B--M-?M?---o-----E-----oo----M-M-E--M-----B----Eo---oB---B----X------E?-----E-oB-E--o---M--E-----?-----oM---B---Mo----X-BE--o---o-----X-M-E--?--X?f
------------B---oo-----X------oE-X----oo----X--oE-----M---B-MM--------E----X-----------E--B-oMoM-?---------o--M--Xo-----?--M-------------X--XBE-----?-B-----X--M--E--X----?---B-E---B-o-----o-----EB--?f
-o-o-----X----B----M--------------XM-oM----BE-EMoE---M---?--B--B-E--o------E---M-----Bo----------------B---X-oB-B------M-?-?oMB-E---o---?E--MB---E?-M-?-B---?--X-o-o----?-----B----Eo?-E?E-E?X------MM-f
-----------B---M-MB-X---B----X-----------B-o?---X--E-E---------M-------?-?--E--X-----XMEB-----M--------?-oX-?-o---o-M-?B---?----E--o--M?-o--M-----E?--o----------o-X-o-E-E?-----Xo--BXoXo---------B----f
m--Eo-?------------B--oo---EEX-----?--X---X-T--E-TE---Eo--B-BB---M----oB--M-?--Xo-B--X--BBToB??M--?---?-?-B-MM-o----?E------Eo------?--Eo-----------?-E----M-o?---M--X-ME---M-----T----M------E--?Mo---X
XXBXXXXXXXXXXBo?XXXoXXMXBXXMBX?XXEEXXX?XXXXX|XoBE|XXXEMX?MXXXXXXXX?XBXBXXEXXXXX?XXXoXMXMXX|XXBXXXXoMXBXXXXX?XBXXX?XEXXXXXXXXX?XXoXEXXXXBXXEXXXXoXXXXX?XXXXXXXXX?XXXXXXEMXooXXXXMXX|MXXEXXXMXXXXoM?XXXXXX
