--------o-----------------E----E------X-------------E------o-----X----------Xo---------X-----X---X---------X------oXo-------E-------X-----------oE--EX---E-----E---------o----o------oX--------E--------
--Eo-----XE--------o-----------------o-----X-EX--------X--------------------------X---E---X--o----X-------oo-------------------E----X----o----o----------oo---EE----E-----------E-----EE-E--o----X----E-
-----EX---------EoEE-X-o-o-----------------------o----o---------X------E-----E-X-EX-----E----------X-EE-E--------------------X---E-----E-X---oXE--EE---o----------o-----------------oE-------E----------
-E--X----o--o---X--------o-------EX-----------E---E----------XX--X---------o-------------o--X--E-E---E-----o-o-----------------------------o-X-X---------Eo----E------E---------------Xo-------E--------
--E------------------------X--X------X-----------X-------------X-------o--oE-----X---o----o----o-o--------X------X--E----EX---XoX---------oX---------X----E----o--X---------------X-----------E---------
-o------EE-o--o--E----------------o------o------------X-----------E-------X-E-----o------------E--E-E-----o-XE-o-------o-o---Xoo-----------------o----XXX-------X----------E-------o----X--E-------E----
-----X-o------o-X------------X-----------------------o---o------------EEX--------E----------X----X----Xo------o---------------E-X----------------X--------------E-----o-----X-o------E--E--E--E---X-----
-E------------E---E-----X-----X-----o------E-----------o------o-------o--------------E--------X-----------------EE------E---------------------------EE---------oE-----E---X-----X----------o---X---EoE-v
-X--B-B---XM------M------E---?-B-BX----XEo-o-E--?----B--B-?Boo--EM-B--EMoM?----X------B-B-------B--MB-----?-------M-o------M-X--E--X---------??-------X---E--o-o-?--X--M---M-o?EXM-E--?----BB?E?oE-----f
--X---M-BB----X-X----E-X--B-?-E--X-------M----X--------E----E--B---M---------?------X---------M-B-----------o---?M-------X------X-B---E------BXB-----Eo--oB---X--??-?--X----o--E-X-----------BX---?X--Ef
-ooM--o-----E??-E--E-E------B-E?-ME----EB---?-M----------?-MBo---XEE-E--oME--M--------B------E-BEoo--?--o----X-XE--B-E---?------?---B-EE--E-----E------B--o-MMXo----M-o-E------E--M-B--o----X-E-XEEEo?Bf
--???o----M---E-X--o--o-?--B---?-------ME-X--o?--o--------EMX-oM-X---E-----EoE--B-MM?-X---o--EB--o-o---Bo-E-----BB---o-B---E--E-----B--B-------X----E-E---?----??X-----B?-X----B-o---o-o---X-----?o-E--f
--E-----------B?-E-----M-X--------oM----E-?-o--M-----M-B------BB-----o--M--------Xo---?-?oE-----X--EEXo--B----------M------B-MM?------M--------X---??M-----oMXB-E-X-M-oEM-M-XB-E-M---?----X--------?-o-f
-?--E---EBB--XE-oo--------?E--X-o----B--B----EX-------o---------?-X--M?o-E--MM--E-X--o---E-B---?oo--B-------------?-?-?-E---?--?-----?---EM?--?-?-oB---B----M--M-----E--------?------B--------M----B---f
mE------E--o-------------?-MM---M-BM--?---M--------XoB--oB------------Xoo--X-------X---X---B------?-X-Bo--o--?---?--------E----E-XME-X-----M-o--X---EEo--XE------MBo---?--X-o-o-----o-----X--BEB--B---oX
XXXoXXXXXXXoXXXXXoXB?XoX?XMXXXXXXXXoXXXoXX?XXXXXBXXXoXXXXoXXXXMXXXBXXoEXBXXXMXXXXXXXXXXXXXMXXXXXXXXXEXBoXXXooXXMXXBXooXXXXXX?XXXoXMX?XXXXEXoXXXXXXXXXXXEXXXMXEMXXXXXXXXXXXMXXXXXXXXXXXXX?oXXEXoMoXoXXXXX
