T-----E---X-------X----M--B-?B-o-----E----M--X--------o--------M---------M--E-----?------X-?M-----E----o-X------------XM-X?-X----B----XX---------XoX--?o?-E----E---E---?-?M-------ooM---?--E-X-B-M-M-M-E
--M-B--X----MEM--X---?BME--M-?----X-----E--X----------XX-?-?--oE---------E--X-M---X-M---oE-M--?ME----------------X----E--XM--MoB--?B--Mo?--M--o----B--M-??----B?o------oB-------?------M-E-------?-E---?
?----o----X---B---X-o----------?---M---M------X------M------X-----B-?---XBB-Eo------------EE-oX---E---?-o---oXM---?---oo--EE---o--o--M--XM--oX-B----o---o-----BoM?----BM-o-----o-o-------?------?-----?X
M------XoE---M-----M---E-E-----?-?--------?M---?-?X--M---B-------M--o?E?E----B--?--M------M-------E---B---M--B-M--B--?------?-oXM-E-----o-E---------B-?----EE-o---o--EBEX-o---?---X---o---E---?--M-E-X-X
BB-Bo--BE--o-------X---------------------X-M---??oE----E---------XB------BX--o------?o----?---B-X---o----B-----E---o--M--X------o-o--?E------------o---X----MB--E?-o-------M--o--X----?--------EXX-?E--M
MXM----------X-----------X---?---BX--B-oM-XXoE----XE-----?---B--MX--o--EB-------?X-------B??------?----XB-?X-B-?E-?--------B-X--M--B----M-XM--------o--M--------?M-B-XM--?---------?B----Xo-?-MBo--X?--T
E---?--X-?-oBo---X----BB----E-o-Eo--E----o-----------??-M--M-----M---------------X---------M-----BX-----EE-E-M--M----E----M-----o--oX-X---------?M-E--M-M--Xo---X-----E-o--EB--BMX??--------?----------?
|-oBBX-MEX-X-E-----BX-?E-----o---X-MXE--o-------o-oE-------E-----B---BBE-----M--M-o-------XBX??-o-E---?----------?-------E---EM?----MB---X-B?--E---X------B-oEoM-M-----------M---M---------E-?-E-------v
X--------B-----------E--oE----------?---oo-------------X-M-----B----?-o-EX-----o-M--EX-?ME-------M---M----X----MoXo-------o-M--X-MoM---?E-XM--B-----E-X-?X-----Xo-BEoM-X-B---o--Xo--Bo-------MM---?----B
X-XM--oBEo----X------E-B-E---E---BB----M------M??X--B-----------o-Mo--o--M-X-M--------o----??-X-----o------E--M-EEX--EX--M------E----o-------o---o-------o-?--B--B-------------E----XE---o-B-BX--------o
MX-------MB----oB----?-----MB--?XB-?-----B-------------B-?----o---o--------EoE---M-M--B-E--?-BB-ooE-B---BEEX-----------?------X--XB---X-XM---------------BB-B-E-----X?X-M-----M??---B--o-----o-------MMo
M-M-E--B--o----------X------B---------B--Mo--?-X----oX----?---MB--?-----oXB-B?--oBB---MBM-?------o------?B?------o-X?-EB----B--?-ME------o?-X-?MMX-B-B---B------M-MM-MXMB------o-M-------XX-B---?----EoT
E------?-E?-------B-o-MB--?M--Mo-----B--M---X--Xo---B-----X---XM-X-----M--B--------Bo--Mo--M--?--X----X-E---------X--o-----BE-----o---?-E--BM-M----------X--o--EX-B--M----X---B--M----E?------BE-o--M--|
B----M--B---o-B---X----X----M-----X-----ME-----M---------B---XB--M--B-?----M-M--?------E---M----?-?----------o-o-----M-B--E--o---B---?---XBM--------B--EB-B----E---------------?E---B---E--BE--X--X----B
m-M-o---M--M--X-----EEBooB------B-------X---X----MB--?M-M--E----B--M--E-----M-X--?X-----o-----?--BX-E-------o--------EMB---B-----?--?---MoME-BoB----XM-EE----XEBX-M------------M---X--Bo-X--?BX-------oB
XoXXXMXoXXXXXXXXXXXMMXMXXMXXXo?XXXX?XXXXXXXXXXXo?XXX?XXX?XXXXXXXXBXMXXXXXXXXXXXXXXXXXXXXXXXXXoXXXXXXXXXBXoXM?XXXXX?XXXXXXXX?XX?BXXXXXXXXXBXEEXX??XXXXXoXXM?XBXXXoXEXXXXXXXXMXXXXMXXXXXXXXXoXXXXXXXEMXXEX
