----BXMBoo-----------E---?BM--------o-BBX-------X--?o-M-?o-----B--E---o----E-----?-------------------M-?-------E--o---------B--B-M--?------BB-------M--B-E-------B--X---?--------o--M----M?--X-o--o--XM-
--?-----E--XMoX-----E-M-o--E--------MX------?MoX--MX---E?M-M-?o-oo-------BM--M--E-XB?--X--?-X-B-----o--o----Bo-----XE-oX--E------X---?---E-X--B-?----M----ME----o-B-o----X-----?---E--?---E--------M--o-
----B-E--o--EM--?-----?Mo-------o----B----------?-M----------------oX---o----?------B-----o----------------M-XM--M---X---E-oM--?--X-B--X--oX-----B---E----------M-X-?-----XEB-EME-B-B----EM-M-E-B--oB---
-?--B---------------E??------M----M--?o--Bo-E--X------B-oB----o----E----B-MX-M--ooo-M----?---M----o-----o-BE---B---oo?----o-XMB??B--?-XM------X-----M---M----M--B---Mo---------------M-----E------------
-XXE-B-----XXX--X---B?-----M-------?--B-?E---M?-B-X---B-----B?--X---------?---------o-----M-oX--B---X-E-----M-?B?---E-X-------B------?B--oE?EB----X--EB--M-----------XB--E--B-BMX--M-B-----M--B---MB-M--
-M--?--?--X--BM----MM----o-----X---ME----?--BBM--?BME-------------?BBX?---M?------B-M---o-XEX--E---B-?E-X--M?-oo-E-XX---o--oo--M-----X--oB---X------oM--BB-----MXX-X----------??---EX-X-EE--o?-----EE---
-----E?-B--o-?---M-----B--X-----------E-o-?M?----E---o----X--X--X-----?o---------M?---------X-M--E---B----M---o-o-EX--X-o-oEM--M-----X-------XX-----o-oB-B--E-?-BMEB----M------o------MX---X-----X-?----
-MEo-------oE--M-----X---o--XXMM--M--EB?-M---------E---B------X--X-B?E---------M----------E------?B--E---Eo---------------oM-----o-X------B--o---X-----X---XE-------B--X??-o--------E---Xo---------X--?v
------oM-?EX-----XX--EM--?----?-o---XX---o-X---X--??---EX-----o-o----B-----MBB---?X-----B-XE----X-M-----B---B--------------?-oB--EBX----o--E---E----X--E-----------X-M---oX-----M----EEo-oB-----M---?-Bf
---o-----X?---M--?--M------E------E---B-EoMXX-X?M--X-o---------BB----?--X--?---E?--?--XM-?oB-B---X-------------X--o---M----X-?M-------------E------M--B-BM---?-o---MB----Xo-E-----B?-----XBM--o-----M-of
-X--B--EB-----X-?-----X-----------B------X-----X---?oM---E---------oB-oE--o-o-M---B----M------o-o-?M----?----?-BX--E---?--X?-o--M---Eo----MXo---BM------M---M-XX--?X-E-?Xo---M--B---oB--B--B-----o--EB-f
---E-?-----EE-----B---B---X-----E----M--ME--MBM-B-----B-X--M--Bo-?-B?B-XMX--B-X--M-------BB-B-M--E-M---o?XE?-?oX-?--B-----E--o----------MBE---Eo--------B---EMo-MB-X-?-------?--M-?M-?M----M?--------?of
-----------o-?--?-M------M-Eo?-M---?o?-o-M-?-M----BM-B--?----o------B--o---?--XE-------E-E-X--M---X-M-XE---B------X-M-----o-E-----M-??----?-------------o-B---ME--X--Xoo--X?--XEE---?-B-----M--M-E---B-f
-M-B--?--Xo---------M-?-o----?-?-----?---?----B--?-M----M-?-----o--E-X--M----E-----B----------Xo-E----------X-B-Mo--o---B---X-----?-B--M---o-??----X--?------BE--?---X------?-??-o--X--M----EXM---M--XBf
mE--E------X--X----?-E---BE-o--M-?-E-X----o--?-o-------B---Xo-------?---------M----M--?Mo-------X-?EM----X--M--o-oMB----?--B---BEM-?--M---E---B--o--M--B-XB-o-------oMo--X----M----E---Xoo-Eo----Eo--?-X
XXXEX?XX?XXBXXMoXBEEXXXXXEXXXEXXXXXEXXEBXXBXXXXXXXoXXXXXXMXXX?EMBXX?BXoXXXXXXXXXBXXXX?XXBXXMXXMXoXXXXXXXX??XXXXBXoXBXXXMX?XXXXXXXXXXBEXXoXXXXBXXXXXXXXMMXXoXXXXXXXX?XoXXXXXXXXXMo??XXXEXXX?XXXXXXX?MBXXX
