----oB-B?--B-B?MM--o-B-------------oE--BE-EM-o------B--M-----B-EX-M----?-B--M-----------B-Eo---?B-?E----------?--B--E--------E-X---?-----------o?--B-E?X----E-E-----E---X?----Bo---?-----B---E-o?-------
------ooXXBMME----?---B----------B--X-------BM------o-------MB---?--?X------?--E-----B----o-----o-o--oXM---o----o---E--Mo-------------------oE------------X--M------------B--?M--o-B--XM---E---?--X-----
-B----M---M-o-EX--E--B---BEM---E----ME----o---MM--M--o-?XB--oo---o-?o----?---EM?----E---?---E---------XM----------B----?--?--M-?BEX--E--Mo-E---------X----------BX?---?o-E-o-X--o---o-EEo-E--EE-MM-B--B-
-EE------?------------o-----------?---o?B--------------E-X--------M-E------o??--------?---E-X---EE--E--B---BEoB-?----B-?-o--EE----?--M-X-?--X--------B----B-----M-X-o--?---o------------------B-XXMo--B-
-Mo-o--?E-M--------------X----M--E?--?-X--E------E-o-o-XMB-B?B----M-E--oB---------o---E-------M-------B--B--?-----X?E----?----------Eoo-oEoE-M---X-----M?B--E---E--EE-E-B-------?-??-oo-?--M-o-?X-------
-B--M-----XE----?MX---------?---------EE-o------M-M-----?----?----Xo?-M-----M------E-EB---X----oM-E---B--ME-?--------MM?--?--o?--------?-E-B------------E--o-?-----E--?----E-?-?-X-BB-X---B-B-o--M--o---
-B----M------o----X--EE---------?-XX----B?----------?--MBo--M----?--B---XM-----?B------?E---?X---M----?B?o-BX-------X?---------------B-----X---BE--?----MM--o--------B-X----------?-B-?--o?-----M-M--E--
-o--E--E------?-X---------BB-X-X--------o---M-o-o-o-M--?-----M--E----Xo-BM?----------X-?------Eo--?-------E----X--EE-o---X---E-E--M--EMX-----EE?------oM---?--M-Mo--E-E--BM--oE--??-----B-X---EEM?-EX--v
-----o------------BX-XM--X---X--X---oEM--?---?----BMoX-----?o-----?X-----?-----B-o---?-Eo-----oB-------B------B-E---E-----X-------M-----------?-?-?-o--------B-E---------E-----?-E---o-X-----?-E-oM-?--f
-M--E-B-E--B-----?------B------E--o--------B?----E-MEo----o---oM-------------o--X--E-oE------oX----o----E-B--X-----B----E-o----E----E-X-E---X--------Bo---------EME----E--------------?-EMo-----o-?----f
---M-----X-MM-----o-XM--------B-Xo----?-BE----------o?B-B----B----o------?-----M-X--XX-?--B?M---B?BBB-MXX-?--o-X----B-??-EX-----E-oEE-oE----E-M---M-B------?M-E---EM--o--o--E--B---X----------o-?-E---Ef
-B-------E---B--E---------X---BX--X-----?XEE?--X------XE------Xo--BB---o-----?-E---X----BE-B-?--X---M-----XB----o?M-------B-----???----B--o------?---o-o-----BE-------?--E--o-X-X--X--------o------o-X-f
--o-------BMEBE-?-EB-X----Xo---------o?-E--------Mo--o----?o-o-M----B--MMo-M-oBoM?-----Mo-?---E--?oB-B--oB-EXoM?--B---XE------X?--------BX---------X----?E--M--?E-?X----E--o---M-----X-?M-----X---??---f
-X?----X------M-B---X--E-----BM-X-M?XE?--------M-?-E-MM-----EEo--M--------E----E-X--o---M-M----------o-------o--E--------?M-?----M-M---MM-?-oX?E-MB----------M--XB-------X--?B----M----?B-M-oM--------Xf
m-----X---?---?--M--Xo----oM-E--X-B?------oB-BM--XM?---B?----X?-M---------E-??--M-----?----------B?-E------?-E-E--?-E---??----?-E--o----o----E?-XE-E----X---BE--E----?-----M---BB---?-o--ME--X------M--X
XXXXXXXXXXEMXXXMXooXXXBMXXEXoXXXXXXXXXEXXEXoXXXXBoXXBXXXX?EMXXXXBEXMXX?oXXMXXoMMXMXXXXXXXXXM?EBEXBXMXXXXXXXXXEXXoMXXoXXXEXXXoXBXMXXXXXXXXXXXoEXXXXEXXBXXXXXXXXXoBXMXXoXXoXoXXXoXXXXXXXXMXXXX?XMMXXXXXXXX
