--------------------------------EX------o------------------E---X-------o------X-------o--X-----X-------------------X-o---------X---Eo---XEo----------X---E-X--o---oo-----X--------------o---EX-------E--
--X---EE---------------------o-------------o---E------E-----E-o-E-----E----oE------o----o--------XX-----X-E-E-------------X--o--------o--o-E-o-----E-E------o--E-------E--o-----E---X----E------------X-
--o-----o-E--------------E--------------o---------------o---X--X-E----------------o-X-----E--------X--o---oX---------E--X--X---------------E-EE--------------o------------EX-----o-----------o--X----o--
----E---o--X-------------------------o-X---oX-X---------o--E---oo-------------------o----X--X---E-E---------X--E-o-----o----------------o--------oo-----------------E-------o-----o----X------o---------
------------------E---o---XE----X----E----X----E------o-X-------o----X-------------E------XX--X---X--------------X---E-X--------E-X---------------E-o-o-------------------o--------------E-------X----E-
-------E------------------E-XE-------o--E---E----X----E-X---X----------oX---o-----X-----E-----Eo---------------------X----EX---------o-EXE----------X--o--X--------X---oE---------------o-E---------X---
----X--------o-----oX-----------E----E---E--o--E----E-Eo--o----E---------------X----EE-----o-----Eo----X------E---E-X---o--------X--------E---EE--X---X------------------------------------E-X----------
----E----------------X-------------X---------XoE-------------XX-----oX------------E-------E---X-----------E-----------------o----E----------------------EX------------E-------------E----o--o----------v
-?--o-B----XB--M---M-----B-----X--B----------M-?--o-?EM----X?-o-B?o-o---M-E--XX---o-X-----B?M------X------X---X---?----M----M-o?EXo-E-B-------?---o---o--o?E----M--o?---------??---?---EB-----BB-------f
-XX--?---o-MB--XX-Xo----X-------X-??-M----------------o-----XB---M----?-o--X--XB------B?-oM--B-M-----M-B---o-oo--EM-M--o-?---?--EE-B-----------X---------------o-?--B-EEoM--X--ME-------E-o----E-----?-f
-M---B-----M-?-E---E?-B---B--B-o---M-X-MBE?--Xo----X-M---B---M-BE---?-?-----M-E-XX?-?--M--MM------B-B-M-EB-------Mo------o-X-EX--MM----o-----?BB--?-o--------M-X?-M------Xo---M----B--X--M--?-------X--f
---?--B----E-?-E-------oM-----?-oBE-----EXX-?---B----ooE--E----------------B-------oX--B-??--B----X--o---o---------------oM------?--X---o-E--M----------E?-------M-BMM---------------M-??--E--M-----o-of
--oM-o--------X----------------o?EME--X--B------B---?------------B-E----M-----oX?M---o--E--M---X-M-o-o-----?---B-XBo-o-----?---------o-XX-----BEB?XB--Bo---B----X-BXX-E---o------B----B----------?--o-Xf
-----Xo--X-------------ME-E----o-------------BM---M--X------------ME-E-MB-------M--X-B?------X--o--X-M-X-o--B?-o-oE-----B-o----?-B---B-E-?----M-M--MBoMME-oo-------B-------B-----X--o------B---Mo---B-Xf
m--X--------??----?X---------E--------o------EB--M-----------BX----?------?--M-----X----B-------------B-----o------E--XoBB----X-o--------B------Xo---??-M--?Mo------o-?----B-----?---X---MM---o----X---X
XXX?X?XXXBXXXXoX?XEMXXEXXXXXXXXXXXXBXoXoXXXXXXXXXXXXXXXMXXXXXXXXXXXXXXXBoXXXXXXXXXXXXX?XXXX?oEXXMXXXXX?XEEBXXEXXXXXXXXXMXXXX?XXXX?XXXXXXXXXXBXXXXXXXXoXXXMXoX?oo?XXX?XXXEXXXXXMXXXXXXXXXX?XoXXXXEMXXXXXX
