--X---?-B??------M-----?--------B------o--B--oB?--E?-------BB-o-B------?-?--BB--------EMB---?EoM-B--EXM---X---B?-------?----B-B-B--M-o--B---o--?------EoM--XE?--oo-?--o---E-o---------o-XB-X--E----?Xo--
----?-M-------B?-X-X--?M-EE-?-?---B--EM--?B--------oo?-----E----B-------oM-E-E-o--X?----?MX-B----Xo-XX----M-Bo?---?--?--?--M---XB----?---Eo-----?-EB-----------M-?-----?---B---M---B-E--oM?------?-BB---
--?--o-----?--o-X--Bo--------M---E--X-E--------EB-B-------?--XX---------E?-MX?--X--BX-X-oXXX--E-------o-X--?---?o--B--XoX------o---M------B------o-----?o?--?----o-X--M-B------?M--E--XM--B-M--B----BE--
-------X------X-o-oM----X--E--M-E-BM-E------EX------M---E--------M---E--E--BXX-X--ME--X---M---o----EB-------X------X--E-M---oX--B-------?-M-E--B------E-o----E--??--MoE-B----o------o-??B---B--M--B-----
-M-B-----BXX-BM------------X-X-?---Eo---?--E-M----B---oM--B-?-?-?E---EBB-B-B--B-M------?---E-X-----X-?oBMBo----E--B-----?--X---M-X--M--MM----o----X----o?ME-B------?-M-oM-----X-X-M-?--o?------M--o-?X--
-X----B-?---------M---o-X-----o-----X--M-----B------E--M---X-------E---EE-X-BM----B--?-----o-MM-X-B-E?-?---M--o-B-?---------M--B---B--?--?----B?----X--BEX-M------M----------------oE---?B--X----o------
---?M----B--E--o-M--?E-?BXX--??-----M---E--B-------B--X--o--X---------o?-B--E?---X-E--E--------------X-E--o-------MB--?----BX--?---------Bo?-E---o-EM--EEM--BoX---MX----??-E-o--?------X---B----M-------
---M-----o-?----------XX--?-EEX-E-?M---X-B-?-----o-E---E-B-E-X--B-X-XX-----B---XB-----o-------MB--oo-------B---?B--M---M-EB-X--MX------------o----M--------------M--E------XB----o---B----B---------E--v
-XoXo--B----o--EX-----o--B?------XM--?--Mo?------o----XM-M---B-Bo-?------B---M--M-B-Xo-----M-o---?-?-o--X-----B--M---oXE-B-----X--------M-M---B---------E--o--X---?--?--BBEB-?-----oM----?-----E-B-X---f
-----o--o---M-------EX---X--o---E--?---B-----XoM--o-M--X----X---B?-B---------B----E--oE-XoE----?-o--o----Eo-?----M-?EXB--------MoEo---------M-ME--o-B---------o------?--Mo---X-Xo-o--X---X-----Eo-BEBXXf
--B-M?----------?oB-o---o-E-Eo---B-MB-XX--B--X-Xo----B----M-o?---X-EX---BB---BBBo-M---?-EE-o-----X---E-?-oEo-?M-----o?---?-----o----E------X----?M----Xo------M-----E-B--?---B-B--X-oX---EX---ME?--?-EMf
---E?---BXX-E---M--------X--X-BXB-?----MX------E--M-----?X---o-?-o--EM-o---------?-?-------E--X---E--M----EB-?-----Eo----o-X---X----?-----XX-B---E-----E---X------M--o-----E--B--------?-------X----?--f
--E-------------o----E--B-o-MM--o---------o--X-----M---?-------B-EX---??---X--?--o?------XEX-?-----X----o-o---------B-----B-X----M--X---oM--------o--oE--------M----o-o--X---------MX-?o-M-------M-----f
-B-----E-?----------X?-Bo-E--B-o---X-----------o----?------B---??-------------ME-M-BX-EM-BB---E---E-----X----?X----X----B-?----X---E-----BE?-M----M----o-o------M-B??-?o--B--M-----B-----MMB----E-E----f
m---?-X-??X-----E-B-?-----?--MB-------M----o-----E--X-------B----o-M----E-----M----B-?--X?-----M--X--o-X----EE-M--------B----?X--X--M---?M-oE--M-E-E-Mo----------B-B--------EX----------BB-MX----------X
XX------B??-E---------X-?----B-E------------X-M---?Bo------o-M----?--------o----------oo--o-X-------M-E----E----X-B-M-BME--X?--M--?----BX--B-------XM-o--oM--MXo---M?M-B--BBo--B?-EM-?--?-----------M--X
