-EoXXE??-?--BE-XE-oM-B-XBMM-oE-----B-E-EX-XM--?EE-E-?oEM-E---BXEXEX?B?--B-B-XooEEXX-o?BXX--X--ooo--oo-B?-BooXX?-XB-MoEo--EXB--?B--?o-BEBXE-Xo---X-M-oEB-EBEM-EBEXXEXEXoBEoEB-EXM?ooBXM-EXEXEXE-EBX-B?E--
---oXooB--XX?XX--BE--BEEB-BEXE?XE?-EEX-o--X?-MX-BE-Mo-X----oXXEMEBME?B?BEoB-EE-?oXM-BEEEE-BX--oMX---oXEBX-oE?oX----EE-XE--oBME--o-ME---BX-XXEE--BXMEXEX-BXE--MXoXo-oE--BoE-X--E-E?-?-EE-EE-E--E-XE--XBE-
---EXX-?EBX------X--X-XB--B-XBooXX--X--X?EBB--E-EEB-EM--EEoXX-XBEBooEX--BEE?-o-XBXX-EEEEXX---E---X?-EXXBX?-E--oEBoXMM--ooX--EoEE-oXXMXXoB?EB--MMXE-EBoBEEBEo?XB--E-X--X-E?oEMEBXo-Eo-oEB---XXXBXo--BE-E-
-E---M-X-BoEE-o-XX-MB--EXEE-EBXXMo--XE-MXoXXoE-o--MoMEoB---X-B-EXo-?--B-?EXEX-o?XMB-----EM-EEo-X--MEB?oX-E-oE-E-E-MEXXXEXEB-XB-BoX-Bo-X?o-X--X-EoE-XEEEoB-B-XX--BB-E-B?--EooEXXE-EXX-X-B--X-EoE?EoEXBBE-
-XEX--BE-EB--MX-XX?X-E--EX---o-BE-?-XEE-EEXEE-EXEE-XX-oXEoE-?X-XE---EXM-XE--E--EoE-EBMo-oE-E--XEX---EEX---?E-X-XX?---M-?E-EXXE?EEBEoBEM-oE--EoEXE-XXEoEEEXo-Moo-X-EB-Eo--MXXBEEM-XX--MoMXEME?E--EX-X--X-
-oo-o-BX-MX--EEX-B-MoB---XXo---M?MoE-X-EMoo--EXEB?B-B-Mo-XE-Xo-E-XoX-?o---XEXE-X-o-BoXX-B-?oE-B-X--oEB-XEEMXXEX--EXBM?XXXXBo--EB-E--X-E---Xo-X-E-E--X--EB-E-oBoMXXXXXEB?-E-E--o-EEEE-oB--B-E-EXB-BEE?XX-
---oX--X-BoX---BEE-o-M-EM-EoXX?B--XEEEX-XXo-o?-B---B--XoEEXX-Boo-XE-MM-EE-EoEX-EMEB-XEBoE--E??-EX---oXEX----B?-X?X?oX-Boo?E-M-M-XX---?EEEB-XE--XoX-?-----oM--Eo-M-EB---XEXEMXXM-ME-EB-oXMXX--X--XB?X?oX-
-oEX----XE-X-E-BX-EEMBXEEX-XEoMXEXBM-EBBoXXo--ME---XEoXXEXEMB-XX-XE---B-X-MBX-XB-B-EXXEEB-EX??oE---EX?E--MEoEoE?-XXXMXo-XXXBEEEBXEBEXX-XXM-oMXXXE-?XM??o-oX--EXo--E-E-EME-EX-XoEB---B-E--E--?XoB-E?-Boov
-oX-XX-?-o-oX-M-X?X--B--E?-X-?--XX-X-XEEEEXX-Xo-Eo?-EEXBEXX?XEEXEX--EB-XB--MEEE-XEXEXo-E?--?E?B-XXEo-XEXEXoXXBo?-BEX-?---o-E--oo?--E-E-E---MBE--EEXXMEEXEX-E-oEB--XX-o-EE-oBXE--oB-XB?-?EXX-oooE-X-BBXEf
-EX-EE---B-E--ME-EXo-BB--X-MXMEXXBoM---EE-Xo?XMBX?o--Eo?oXEX-E-BB-XoEo-EEEXEX?-EEE--X---XXE-BM-Xooo?oMX-EB-X-XEE-EoXMXEBB-XoXE-----EEoEE-Eo--B--?E-Xo-EX?-XE---EE---E-oM-XXBEX-X-BB-XBE-o-EXo-BMBXXEEE-f
-EB---EEBB-XEBooEXEXEXoEXEooE-E--EE-BEE?-XEEXXX---XM-XoX--EBEXEXEE-XE-XE--XX---oEB--MX---EXM-XoM-?-E-BoooX--EEXo--XEX?X-B-XBXo-ooEX-EEEXo?-MM--XEXB-Xo--X-B-X-??M---o-XXE-EMBBXX?E-X-EBXM--o-XE-E-EXE-of
-----X-?X-XEB-MBXo-M?-M-EBEM-MBXE-XMMEBXMEMX-E-BEE?EX-EoEEBo-BX-ooo-B-XX----EXBoo-EXoXEBEMX--E--E-E-X-oX--MX-?B-oEEXEX-BE--X?-EX-EooBX-XEoEE-XBEE-Eo-XXoE-EEXB--EE-EEM-X-BX?XXo-E--BXo-XBXEX-XB-XE-XBX-f
-XXXoXX--oEM-?MXEXX-EEXoX--EX-BEoEME-X-BE--oXXo?XE---E-XXE--E-?MEMX-EoXo--oEEEXEB---oM-MBoXoBEMEoo-MBX-Xooo-EEBXX-E-EXXoEBo--?-MBXE-BM-MBoEEME?--EE-oXX-B??--MXX-?EXEM-X-XEXo--EME-XE-XEX?XX-XX----E-EXf
-XEEE?BoE-EXEX?---XoXo??-B-BX-XXX-X-oXXBoM?E--ooXE--X-o?-?-o-EEBXBoX-BX-EXEXBoooXEEMo-XoXo-Xo-B-E?EEX---XoXE-oEE-EXEXoMMEXEMoX-EEBEXEMBXBEEoE?BE?-?oXoEEE?E-EEE--BB--XXEXE-XEX--X-oBoMEX-B-EE-XoXEXoE-Xf
m-BEEE--EEE--EEX-ooEEBBBoEEBXBBBEoX-BE-XM--XX-E-EBXEM-oXEEXE----?o-XBX-EoE?X--Mo-EXE--XBB?M-o-XXoE--EoBEXEo-EMo?XE-E--XoX-X-XBB-EXX-XEEEXB-E-MMX-XB--XE--XEBX--EEBXX-EM-oB?-X--EX-EXBXoE-?EEXEXoXX--E--X
XX-o-E--E--o-X-o?-EXMBXXXXXoE----EE-XEBE--o---EBM?B--EM-XooM--XXMEXEMXo---E--XXX-oBEE---X-Xo-XXoEB---X?B-MooEX-XEBX--XE?o-BXo-EEB-----?XE-X?ooXXEX---EooB--B?EX-XXoB--MEEXX?-XE--XX-MXX-EoX--Eo---XB--oX
