---o?o?oM----BX?--XX---?----M----------M--E-X?EB-X-----?X--o--?---X---X-o-E---XEo----oM--Xo--M--o-E--?------E-E-X----------XE------B-?-X--X--?-----?----XX--XMX-???E-E-E?XB---XX--o-XM----X-Eo-M---?-XB-
--?-M-X--M-----X---?-X---E----E---XM-EM--?-X---XXE---XX-XM------XE-MB-X?-----MXX---X-XM--MX--M-------X--X--B-E-M-MB?---?--E-----?---E----EX---?-?-----o--o----X---E--?--X-M--o-oE-M-BM------M--B-B--X---
---E---E----E?M-X----X---M-o-M----o-X-----X--X--M----XoM-EXB-XE-o---------B----XXE-----XE-Eo-o------XX-B-?--XXME---EBo---X----XMXE--?X---?---B-----X-E?EX---BE----M-o?o-M-ME---?B--B?-M-?-E-X--------B--
--XoMXB-X--XE--?-----BEo--E-o---B-EX-M---E?-E?---B-M--o-XM---EMB-EEXXB--E-?---X------XX--B---X--XB?------E?----MB--X--X-?--XE-XX-o----?-------BM-E-o-oEMB---E-?-oB-E-----?--o---BB-X--Mo----o--BBB---BX-
--X-?M-BX--E----------E----EE-----E--o------BE-X-?X--X?---X--B---E--M-----X-X-XX--oEX-X------X-X---------?--o--XB-?-XX-X---?-?-Mo-?--X-o--XXo--------EM------X---E------E?----X--EB-oB-o-------X---X----
-BBM-------X-?--B---X-o-oX----X-?-X?--X---XX?--XB--X?---o-----B------B--M--X--X---?-----X-X?------?-X----M-MBoX-X-?-X--XB-o-------o-----B---------MM-o---E-o---------?------?-----------M---o--M---M-?--
----E---EB?---oX------BMoo---X-X-BX--------?XBE----XXE------BXX-?-E---M?-M--MX----M--?-B---B---M-o-X--X?-X-MME--E-B-?-oB-M--?-E--X----o------X----o--------E--X-----M---X-------XX-X---XX-----------B---
---?X-B----o---------X--X----X----X---MXE-X-XM--X---M---M----E-o--M-B--B-----XE-M-MM-Mo---X-----?----o-X--?X--------MEX-----M-X-?XX-----B--EXE--M------o-------X--X-?-XX---X----o--B-M----XE-BEX-EB-E--v
---Mo----X-?---XE-o-----EM--?------?------X-----X-------------X--------X-M-o---X-XX-------E------E-X?-B-?--M--M----M?--?M---------X-B-----o-B------E-EB---?--o-o-B?X-Xo----o-M-o-BE-M--X-o--------M-?BXf
--MX-o--BEo--X---X--M-XXo--o---?X-X----E------X-X--XE--X?-oo--M---B--X-?-?-BX-X-X-?---XM?---?XE-X-E-o-------X-B-----X--X--E-o-----------M?-??-o----M?E-----EX--MBB---E--E---M-BX---------BX-------M--?-f
----?-?XXoXE-X-Xo-----oXo--X-EB----BB---BXB---------M-M--oX-?-o-----XX----?X--M-?-M-----?E--XM-E--E--X-BX---X-X-M--Xo---o----Mo-o-B--B?--M--X---??M----------o-o-BMM---X-o----oM---BBB---E--B-BMM-BoB--f
--?X--X-----BBX-??--X--X---XoX-------?-B------?-----X--X-----o----E-?E----o--BX-X-X--E-X?M--oo--XX----M-B--M--?-----X-?B---B--XM---EoB-X-o----o---?-E------X---?---oB-?-M--E-M?-XX---X?-----?B--Xo--X-Xf
--------?EM?XM--X-M--B-----E-B--XMXEX-?--B----M----X---M?---?-----X?-M---M-Xo---BM-?-o---------E-?-EM--o----?---o?--XBM--X--E----o-X-oM--------EX-----?---M-X---M--X-BX-E---M-?-X--M-?-o-o-?BBoMX--XM--f
-o--------B-?E--o?---E-X--E-----------o---E--B-X-----XX---X--oo----E-?-X?-oXEB--M-B---EX--X-XX--EoX------E-X-?--M---o-?-M-?-X--E--E--?----?---M-------B----?-------X---o-o-BXB---o-B------??oB------X--f
m-M-----o-------E-----oX-B-?X?-M-B--o--EX?------Mo--?----o--o--X--EX-M-B--X-?-X-o--oE-?---?----B?EE---Moo-o--MB--X----XXB--X-XEo-o-Xo---M--E--X?X-X-E-?-?--M------Xo--E--E--E-Mo----XX---X---B-X------oX
X--X--?--E-EBo-M---?--XBXXE---?------?-X-XX----o---X--Eo--?---B-M----?---?X-E--?--o-o----EBB?X-o---X-E----?X--o--?--B----E?----?-?ME--??---BEEXB--XX--?--MX-E--B-o--Mo-XM-----?B-??-?--E--E-----?---B--X
