-----?---------X------B?--------EM------M--------X-EEM--oE----?-BX---o---X-----B---B-----BX---BBX-BB-MoBX-o-E??------?------------?--B---B----E---M---o-------M-?----B-o--M-?----MBo?------X-?B---B-----
----E---?---X---M--o---------o---M---?--M-?--E---------?-E--E?----M-------------B---MX---MB-------M---M----E---o--?------B----E?----X?-BX----E-E--??X--o-EE-XMo--E---EB?---M--?-----M----M-------M?-E---
----o--X-X----M--X-oM-X?---B----M-E--?---M?-B---E---X-M--EE----------?M-M--B-------E--M-B---------B---o--X?-?XE-oMM--oB-X?--E-?----B?----M-------X----B---E-MoE---XB--X---o-EoE-E-Moo-------MB--XBM-----
---E-MMM--o-XE--o--o----X-----Xo----o-X----B---ME----E-o--?-E--M--B--EE?-------------M-----M-X---------o--ooBB---E---?--BX----o--?----X-----X----o-----E------E-?-EM-X----B?X--?--M----MM----o-MX-o---o-
---B------o------E--MM------?-M---X---E--EB-------o----M--o---B--B------E-----o--E--o-M--B-E--------?-oo-BM?---B--------------B-B---MM-?------M--?--oB-XB--ME-XM------X-?EX----E--?B-----oE-B--M-M-?----
--M-X-BB----?----XB------X?-----XE-----E----X-XB----Eo--?------E--X---------X--X-M-o--X-----E----o--B------B--o---X-----?o-------M-o------------?--oEo--XX---X--Xo-E-EE-B-X-ME------------X----------E--
---B-?-M?E--?oX-E-o-----E---BE-B-B?----X---X---o--?-ooEB---B-----E--B-------o-Bo------E-E--X--M--Eo-------Eo--------E-BX---Eo-BMo--X-------------?B-o------?---------B--B---X----M--------B-B-----------
---E-o-Mo-X--?-E-M---o-M-----o-E--ME-E----B-M--M--?-E---o----?-B---XM--?EB--X---M---o----EM------X--E-----M--E--MB-o---X-X-------E--------o---E-------X---M----B---MEMX-----------?---E-------Bo----M-?v
-M?E---E--X--M-------o-?--E-XEoB--------M---M-?--B-E---E------E---B----?o-----E--E-M-B---o------ooM-XB?----------o----Xo-------E--?--B-E--------oB----X------?-MoB?M?M---o-?B------B-E------?----B-X-M-f
-------?-o---MoB?MM--B?B---MX---------E-MX-B--?---MEM---EM-B----EX--M-B--X-------?---BoEXE??---E----M--?--?--B--?---------X----B--o-----B-X----B-B-----XB------E------o----?----?-B--B--E-----B--B-?---f
----B-o-----M?EBX----o--EoM---------Eo---M---B-BEX-Xo---EX---M---------------------Bo--EX-----X--M-----M---?----??--E----?------X--------E--------MM------B---E---X-?----M---------?-?M?-------Mo------f
-----MM--o-------E-----oEMBE---X-o--?-E----o---B-M---B--X---XX------E-----o----X---------B--------o-----X---XEoo-----E---o---B--oB-M----X--BX-X----E-----BXo-X-------E---E-----o--M-EM-E--BX------o?Bo-f
-M--X-B--o-o-----XB?-----?-----Bo-X----------E-E?-M---B------oE-BE-Bo--Bo-?-M-------E--M---M-?---B-----?----M-X----EB-B----M-B-----E------M-??-------EM-------?--BBM-----X-X--o--------E-X----B--------f
----?---------M?--M------?XM-----M-B-B----E------?------X--------------------------------M------oMo-----EE-MME----?------------BXX---?---------E--B-----?--E--B---BX?----X-?---XM-M--E--?BX-----X------f
m----EM----?---?---B------EX?-----X---?-------?----B--X-------XB--X----o-?-----------EXo---BE-------M----?-------X---XEE---B-?--o--X---?-B-M------E-E----o--M-----MM---E-E--M------?--------M?-o----B--X
XBXXXXXoXXXXMMooXXEXMXXXXoBMXXXBBXXXXXXXEXXXX?XXXXXXXEXXXXXXX?XXXXBXXX?XXXXXBXXBXoXXXXEXXXXXMMMXXXXXXXXEXX?XXXXXoXE?EXXXXXXXMMXXMXXoMEEX??XXoXE??XXXXBXXoXXEoXBBXEXBXMXXXXXXEXXXXXXoXXXX?MXXXXXXXXXXX?XX
