--?EB--?E-o---E-M--o-?MEo-----ME--oMMX--B---o---o-----M-----oX------BM-Eo--BM-o---E--oX--E-----X-E--o?-B--o--BM?------B-?--?-oM-----M-E-E-?-?----B?-E--?---------oX--M-X---?-E--?----------EB-X-o-------
--------?-XX-----------------oE----oX?---?--M-B----?-----X------?-BX--E--o-B----------o-M-E--------X-M--o------X-----E----B-----M-XM-X?--M------E--------M-----X---o---o----------?E--EX-?---B--M-oB-E--
--E-X-B----X-?-----XB--M--o--?----X?--X-----?--EE--------X-o-E--BME?------X----X-----------B---o-E---o--?---E---X-----E-B-----?-o-------------?B--------MM--XB-X--Xo-?o-o-------E-?-?oXBE-------BX-o-?--
---------E-X-o----oM----------E-?-----oMB?-M------------MBX-X-M---o-E---------E------B-ME---o?BE-B-M------------------------B----X-----M--E-----X---------Eo?--?--?-------E---XM-?---E----B-----oEX-EE--
------B--------E-----B-o?----X---E--XXXM---X---Bo---?---E-?---X---M--?---EM--EM-----E-?--BE-----X-X---M---X?-E---EM-B---?---E---E?-?B?--E---E-----------?---X-MMM?-EEM---?-E--?----XX---B--o?-----o?----
--E-E-XX?-B--XBEB--MM--Bo-oM-M----E-M---X--?----E--?-M-o--E-ooBM-o-??E?-----------EE--E-------X-B----M-Eoo----B--M?---M------E--B-E----MX-----M-?----o-?o--B-M-X-o----B--B-M---?--X-B-----?-B?----oo--M-
--?MB--E---MXMo-------B?----------------o-E-M-E----E--o-B?----M-?oE-oo---B-------o--?X-M---X--M-o-E----?-oo-X---EE--X---oX----B----MM----X?B--?-XMM------o----o-----o???--------o-oB--E-M-B--M?----E----
----EB--------?--E-----E-----?----X-M----M--?X-XoX-o-M--M---?--M---B------------o--o---M---Mo----o-?--M--?XX--M---B--??-BB-X----E--X--B---M----B-?-M-----M-o-B----??--MB---Xo----X--oE-----B--EE?--?B-Ev
---?-----?--------MXMM-------X-----------MBX-B-BB-----o--EE----X?---XB-o--o----------E?E----MM--------o?----X?oB--MX-X-----B--------XM----B-?o-B----?--?E---MBEo-----B?B-----EX--?--M-M--E----?XX----Bof
-E--E-Eo---B-----?E-M-----XX-B----o-----o--?M-o-----X---------o--X-X-X--?---o-M----E-----X---------BM-------?----M----?M--E--XB-?-M-X----E----------o---B--XX--E?--M--E---------B-E---B-------M----E--Xf
------o-o?M--?---E--B---M-----B-?---?X-----?----B?-??---------BB-X-------o--o-----M-----E---o---X-X-----B-?-BB---?EX--------E--M-?--?-M--?-----?-?-X--B?--E-?-------o---B------E---B---E------B-XM--M--f
------M---E-----X--------X-oo-?-B---M-?B-o----M---X-------XEMM?-----o-----B--??--MX-----------E-------X-o----Mo---X------?--o------o-E------B---------?--------??----X---XEo-MX-?---E---?M-E--ooX-M-EEof
--M---E--Xo---XMME------?-EE-----X-----X-E----MMX----o----------X-----X----BE-X--oEMoo-Eo------M-o---?----XX------M---------M--o--BX-B-M-X----------M---------E---o-E----X--E--------E----ME----XX-----f
----------o---X----------------?---B-B------XXX----X?----?--------B----------X-o-----?-X-M-E-B------EME-B-EE-?X--XB??---E----?X--M-------E--E-X---?X--EM---MBXX-X-MXB--BE--BE--M----EXX--X-?------M-o--f
m---X-BEX-?--M-E------ME---E----M-E?-B-EX----MEX-?------M---M-----X----?--?oX---oM---B--?E?-?--?-X--B-XX-X--o--------MX----E--M---o-----?--X---E?E-o--EoX?------------E?----X-M--X-o---o--o?o-------M-EX
X--MX--M--?--X----?--------E--oEE-----oE---E-EE--o-E-X---?-MBM-o-E-----M---B--M?-o--oM------MX--M-MB-B-Eo--oE----?------o---BE-------MX---oB--?-B-X--?E-B--oo--E-X---M-ME---?B--EX--------o-Eo--E?--X--X
