-M--------M--EE--MEXBBB-M------------E------X---M-o?BX---E-B----o-----o--E-E-B---------o---E-XB?------X---E--B-----------XE--E-M----E-Eo----EE?oM-B---?---EE--E?---E-B--MB----?---X--E-E------BM-oME--?-
-?MMMMX----X-?B--------M----B---X-----------o--B--B-o-EB------ME--B-----ME-B-E--B----B---X-----o?-E-MM----?-B-B-----X--o---X--o-B-o-E-------?--X--X---o-----B-?B----?-------o------?-o-----E--B-----?M--
--B---?-------o-B?X--o--------X--B-XMB-------?E---X-----E----------ME----------B------XB---EE?X-X--o-----------?---M-M-o?---X--E--Eo----o?-M------X--EB-?-o-o--B-X---X---M--X-------?----E??B----E---o--
--------------------?-M-o----M----B--B---Eoo-MM--B----X?------B-o---B-o---X-------o---X--BX-o-------MX-----oo-BBo--?--??----XXM--X-M---B----E-M-E------X------------o----?--B-------MM--B--------MXM-E--
----------M-M--M----------EX-o--MX-----ME----XX--B------?-ME-EM------?--?---------BB------EE------o------E----------?---X--B-XX?---X---E-X--B--E------?oX--o--X-E--BB----E---------oB-----?--M------XM?-
--XB-o----Bo---M--------BM-X-M-X--------X--o-X----MB--M-----?------B-----E----------------------B---?----o--Bo---?----------B--oE-o--BXo--?-X---E---E-----E-?----B-E--B-oX-M--M--XB-?XB---------X---M---
--?B-?------M---M-B-----MEE--oE----oEM-----------E----o---------oM-E---E-M-----------------XM?-o--M----o---E-Bo--E------------o--X--B--X-o---M-M-?-XM-----------?--------MEME------EB--ME----?-E--------
-----BM?o----B-----?--E?E--E---E--?---E---o----?-oB-?-----?X---------?--------M--B--------B-o-X-o---X-----X--B-X---X?E-?-E-M---B---B-B-----o---?-E---EEooE-?--o------B-----EM-M-----o-EB---X--BBE?-B--Bv
-X--------E-?--ooB?E-o----MB----X--BBB--M-------------EM--M---?--BME------E-EE---?--XX?--------------?-X-----E?-----------o------oE--o-X--o---Mo-B----X--oX-B-----M--B----B-----o?--M---oM--B--B--XX---f
-E?---X---?M-M---M-B-----?-Bo-o---XB--E------?-o---EEo--o-----B-X----M-M-?---?--o-Bo-----MB---X-----M------o-BX?--EX?-M---E-o-MM---XX---B-----EB----------B----B-B----?-E-BXMM-M--?--?-Mo-----------M--f
--?X--E-M--o-X--E-------?-?M--E-?--BX---BBo----oM------B-B------------?------o--?o-E---B-B---?-----?----M---X----B----M-B-?-BMXB---------o---M-o-?o----?o-----X--M-EE--MM?---M--oBB------o-E--o-oX-----f
-------B-----oBE-M--------------M--E-X----X--X-o-M----E--?--B-----XM-EBX---o--?-oM--E--BE------?M-X-----M--EM------o--oMBM-M----X---EE-B-X-----o--B--X?E-----EM-X----MX--B---X-X-X---M-EX----M-M?X--M--f
---------o-MoBB---X-E-M---?-X-ME--B--EE-M--B-----E--EM---oE-EE----X--oM--XE-----o---M------?-E------M-B-?----B--o--E--o-M------XB--------??M-----?X--o-M-B----------E-?----BM---BX-E----X-----B---B---of
---MXM----E-?B------?-M---?---X-?-------B----oBXX?----X----o---E--X-o---B---MX-B----------M-M-M-B---?----------X----XE---EBMMM?---?---------?---oB-E--?-X-?--E--B----?E----M-M----??-E----BM-------M-?of
m---E---E----?-TM---M-MTT---M-BT-E??-M?----M--B-o-B-E---T----T----?-oXM-X-Bo--o---BE-?---T-------BXB-----?T-E-TX-XX---E--T--o-----M---M-o------XXBTMT-----BE-----MMMM?-T-o-T--B-B--X-o--M--??BMT---MT-MX
XoXXXXXXoXEoXBX|XEoXXXE||XXXXXM|BXXXBoMXoXXXXMX?XEXXXXXM|XoXX|XXXXXXXoXXBXXXXBXXXXMXXoEXX|XXXXXEXXXMXXXXXX|XX?|oXXXEoBXXX|XXXXXXEXMXXXMXXXEXBM?XBX|X|XBBXXoX?XEXXX?XoXX|BXX|XXoXXMXXXXXXXXoXXXX|XXEX|XXX
