-E----X?---o-oX----X---XB-----Eo----EX--B-B----B--E-X-X--EM-E-?-----ME-M-E---?---------M-----M---X-o-XM--X-X-----XBo---oB-----B--B-EB?oMXXoM----B--------X-M----?---E-X-M-?M-E--?XX--MXXBEE--B-o------M-
-o--BM-B?----M--??-XBXE--X-EX--EM----BE-M--------?-E-?XBBX---o----?-MB----o-o----X-o-o---X-X-E--------MBBXXE--oo---B?---o--Mo--B-?--E-E?o------EX-o--X--M---?-Eo------BE----M--BM-X---------XX---M-XE-E-
-M?-MB----------------B?---E-E-?E--E--oM?-o--M?--B--X--XX--?-----o--?EXo-X?--?-E--oX-B?XE------M--EX--B----EXo-------o-MXB-----EXBX-----------M-o--X--M--X--M---o-Eo-EX-----?-o-?--------BXM-M--?-B---E-
--?--------?----B--X-E-?-----B--?M-M--M---?---oo---?--B----o?----X-B-X-o----E------BX--MXX-B--B--MX--X-------E------------??o--X-?EMo-----X-E----X----XX--E-Xo----------o-BBB??------X------X---MX--X-?-
-----E-?---------E--E-XX-M---------EMX--BEEX--X----?-----?--?-XX-X--M-oMMo-X----B-X------XX--o-XX-XX-o-BE-?X-X-----B-M---MM--oX-oo-oEB?--------B----------BX---BB--?-M-o??--EX---?----XE-oXX-o---E-XE---
-X----XX-----------o-M--EE--ooE----X----MEE--------M-oX---M----B--XXM--EM---?ooEo---E-----E-oB-E----XXE?-M----??--BEX-B---X--X-----M-XX--------E------?-B--X?B--X-X-M------EX-?-----M---o-----E--X----M-
--B-X-----o---MXX----?-------?--E---Mo--M-XX--M----X--o--BXX---oB-ME---M?-B?--BE---X-EMX-MX?--M?----EX?M-M---M--o-oE--ME--o-o-----B?B---o--E------?--X-E--?-M----M----?-M--E-E-XB--XE-X---M?----?---X---
--------ooEBMo-E--X--XX-M---------X-E--X-?E-----XXoXX-?----X-----X---B-------B-B---B?--X--o--?-E--XE--MBX-ME--oM-B-E--------B----X-oX--MXE---BB----------M----------o--o-o-E-o--B-E-X-X--o-BoX--M---E--v
-X-------X---X-MXM--E----XXE-----o----o-E-oX-EM-------X-BM-?o--X--B-o---o----XB----o-EE----X---BB---X-E--o?-----X----oE--oEMX-EM---------B-X-X--XEB--X---X----?------?---E-?--X------o----E---X--BoXoX-f
---B-E----ME--X-M----X-ooo--M-E--M--X----?-----E----X---o-X---E-oB-E-----?B--o--------XX-?------E-?------o---o--Eoo--X--o-o---?--oX--X-Bo-M----B---EM?---X---o---E-X-E----M-B?----?X-M-X-XX---XEB------f
--------------BEM--?--o-Eo-E-X-------E?------M-E-B-M-X-X-Xo-M--?-------XXEXE---X---o--?--MM---E--?--o?M---?--?-?X---B--E---M---B-MXM----o?XXo----BMo--------B------o-----B--E-X--o-E-X-MEME-BE-E-M---M-f
----o--?----XXB?X-X-?---?-B--------B?--X-X--------E--E?-?----XB--EB----M-?XX-?M-X?---X--E--B------B----EX---M-X-----M-o-----o---XXX---M-BX?EX--X------------?-B--E---M-BX---BX--------B---E-o-M-B------f
---oB----?-BXBM-------X----X-?--X------B?-E?--Bo-?-?----X--XX----------X-X---?----o-?--B-BBBE----BMB--------X-?---B-BoB-M----X--?B---XME----?XBEX--EB-------MMB-E--Xo-XX--E-oX-X-BM--XXEMo--B-M-----oM-f
-X---BM-E--M-?--E-----EBXX?--Xo---B------X----?----M--?X-E-?-XX--?E-X----X----?M-B---X--EX---M----M---E--Xo-B-E?-X-----o---Eo---Xo-MX--------EEM-EMXM-o-?---------E---XoE-o-----------o?--E-XB-----B--of
mX-EB?--BX-?---X?----o----MB-XX?-X------X---XXX-?E---o-EXo-X--XX?X----E-----B-E----M-----B--X----B-XX--E-?---BB-B----M?-X---XX----M---B-----M--Eo---B---?------XXo-X--B--B?-o--------X--X-E---?--------X
X----X---X---E---?M----X-E---------X-----E-o--M-X--M-X-XX--M--B---o-?o--E-B-----E-?---MX---------X---XE----B-Xo-M--o---XB-o---XB-?X-BE--E-EB-?-----?-----Bo--o-o--B-?E---E-X-----X--B----X---X-M------oX
