-E----Bo--o----?---o---E-------o---------?----o-?----------oM?Mo-X----Mo-o-o-MEXoEXE--M-E------X-?-------M?------Xo-E-E-o---EEM-----E-----?--oM-E---B-----o---M-------o-----?ME------?-?-?-X----E-------
-Xo---M--?-o-------M--------------E-XX----X--o?E---oM--o----E--------E----M--?-----------?Eo??--E-------?-----oo-MB--E-E-E----X-----X----------?--o----M-?------B?--ME-X-B--B------Mo----------E-----MB-
-M---------?M----------X--B-----X-------?o--Eo--Bo-XB-----o--X?X-----?--?--?------M----M?M--B-BX-o---XXB------?B--?---?--o-E-MM--EM---BE-X----o-----X-?--BB-E---E--XM--M--E-EEM------?-B-?----------X-E-
---X--o----?X-BM-------XMo-?----XE-o-X---oo-MM---oooM---------------X----o-----EE---------EE--o----------B----BX--------M-X--BE---B-oE--M-----?-------?---------E---o-B-o---------X-X--------MB---M-----
-----MEX----?---------Bo--B-B-?-o-E?-?----------M-E-------?--B-o---o---X--------X-E---B-oM-o--E---BX----B?------o-o--BE---XB---MM--E-M---M-B--EMB-X-----X--------M------B-------X-----?--o-E--------E---
------E-XX---------BM-o-B----E------o-MM--?------B--E-----M?-B---o----M-------o---?-?-M----B-EM----o?--o--o-X-M---?-------B--?---X-E-o-M-E----B----X--ME-X-oX?----o--X------B-B------X-o---oBo---o---E--
-?o--oB-?----------E---?-M-o---M--oE-o---?----?MB-----X--MM?------o-X----M----------E---M?-----?E--------?-E---o--M---M----o--o---EE-B------o-E---??-X-M-E---------E?M---M-EB-?---?o-----------B-E------
--E--------o-?----?X-----o---XXo-M---------E-?-E?-E---o-E??E--M?--EE-X---E----oB-MM--B-BX------B?---M-EE-X-X-------X-B-------M--?-XB-------B----?B--X-XM--o---E---X-?----?X--E--X--X--M------M---B----Xv
-?--BX-E?-B--X----X?--?B-M---------X-----E---BM--E------o--B---EB-oX--X--?-X---?-oE--X---?B?-----M-M--?---Xo-M--M----------?X--------E-----------B---o?---?B-----X------B--B--------MoM-B---o--B--o-M--f
-------------?----MM---X-?-----BM-----------E-B--------?--XX---M-E-M----XB-----M--?--oM-E-M-E---------------?--------------M-----o-E------?----oEE-B------E--?-E---------X--X--B--o---o-o-?XM-X-o-?-X?-f
--EM?-------o?o---MoB---o?-E-o--X---MXE-?X---?---o-X-----Mo-BE---E-------o-M-X-------oM-------------E--?B?----o-B-----E--?-?--B-B-M-E--XX--o------o-------M-o-----------M---B--E?----oB-B-M-----?E--M--f
---E---oM--o--E-o---o-M-E-oB-M-M---M--?---X----?M-----XMB-------B-B--B---BM----XM--------?-----BE-X----o-----MMXE---E-?-----?--?-Eo??M---B?-BMM----B-?---X-o?oXo-----------Xo-------------EBo?-B---X---f
---MB-?X-B---o----X-B-?-E---M--MB----oM--?---B----M-o----E--M----------------------?X----E--Mo--?EB-----BM-ooXB---E-?EB-------?---E----E-X-?---o-----?--B--Xo-ME-o-----o-------?B-M----?---------X---M-f
-B-X-o----M---EM---X-------?-B?-o-X-?--M-?-XBoo-?-o-X---M--B-EE--?--X--------------EEoo--o-------M----E------M---------B----------XX?------------EE-o?--X--?--B--M-M----o?-------E-X-oX--BM----o-B--X--f
m--B-E----X-B-X----E----o------?--------?----?---MooE-?E-------?-----o---X---E-------Mo--E----o?----E-------E------X--?E-EB----B----Bo-M---E--E----M-?-E-X----E---------M----B-M------?-----?-o--------X
XXooMoXXMBMoEXXXXMXXXXXX?XXXX?XXoX??MXXXX?XXMXXXXMXXXXXoXXXXEXXXXXBXXXXXXMXXX?XXXXXMX?XXX?XXXXXXXXXMXBXXMXXXXXXBXoXXX?oMXX??XMXXEXXXEXXXXXXBBXMXXXXXXXXXXXMXBXXXXXXEXXXEoXXXX?EXXBBXXXXXXXXXXXXXoXX?XXXX
