-?EBXXB-XM-?BEo--EE--MM-MEXBXBMBBB-XMo-B?ME---XB-X-M?-oEEE-EEooX-Eo--BMXEEEo?E-o-XBE-E-oX?BB-EEBo-E-EX-EoXXXE-?XXX-EXX--X---XXE-BE-XEo?--?X--XXX-X--EX--M-BoX--BE-B--B---o-oEXXXXBX-B-XEX-?-?E-o---EBEE-
-EEEEMEEBB-Xo-E-E-oMoEXoXoE---X-BBE?-oBoEE-XX-BX--MX-Bo-XB-?-XX-E?XBB-XXX-BE-X---EBoEXEEXMoEEXBXXM--XBo--?o-XB-BE-----EX-EXEMEB?oXE--E--E?X--?-BEX-XM-oXEEoXXXEo-EB--o-XBX-Eo-M-XX?E-EEoXEX--oEXXo-X-B--
-E-EEo-EX--BM-BX----EEXEBMXoMXEBEX-XX-ooBX-XX?-oXXX-BBXEBX--B--?oXE--X---B-X-EB-----BEMo??-XE--Eo--E-oM-XBEEBXX--XXEE-oXX--B----oBEXXM--M?-Boo?B?--EEEXBB?---BE?Xo-E?EXXBBB-BXEBoBEXM-Xo-X--BM-oo-oE--E-
-?BE?XM-B?EEBE-o-oEo-oE-oME---E-oo-X-EEEX--XEoEEX--X-B?--EoXoEXo-Eo-------XBoXBME----X---X?-MX----o--XXo--XX---oMBEXE---E?---X---ooXBXXXoE-?o-oX--XX-EX?X-EE-oEE-BXXoEEXEXoEXX-Mo-M--B--EEEMo-BEo-?MEoE-
-BEBXB-BBoooE----BXX-MEBEoEXEME-XX-o-oBX--EEX?X-E?-XXB-EB--B-EB-EXEoXXE--BEXEM-B--M-oX-oX?E----Xo-XEoXEo-M---EXB?XoEEEo?-B-E-XoXEX-E-o-Xo-?oX--EX--BXoE-Xo---Eo--EXo---?XEMM--XX?B?-BoEX-B-EMXE--E---BM-
-?oE--X--XX--EX-o-B--E?---XooM--EB-EEB--XX?o-MB-o-oEEE-o-B?MBB-Xo?-E-?-ooo-XEXoE-EBX-EEXE-XBM-EM-BBXo--B--E-?--XEoBEXoXX--B-XB----E?EXX-E-o?oEXXXXBo--oM----E?X--E-E-EoEBBXX?o?EEE?ooXBXEEXo--oEX-oXX-X-
-Eo--oXoEXXBX?EXo---BB--E-X-oE-BEE-BoEEX-X-XBXXBoX-?X-oXEME--MoBXXB--X-?E--EB-EXXM--EE--XBE-EE?Mo--o-E?E?Xoo-E-XXEXEo-B--o-EBEBB-E-EX-X-EE?EXEXEE-oEE-EXB-B-XEE?--X-oX-XXEXXXEEB-X---EoXE--X-Bo--BXBX-X-
-M-XooM-B-o-X?XXXX--XX-XE--M-E?-E-Eo-oBXBEME--B?EX---EBBX?-EE-B-oE--EX-o------XEo---XXEEEoXBXX-E-MoB-X-ME-XXX--EEEBMX?E-----EBXEXEEE-B---B-oEBBMBEE--BXo---EB--E-oBo-EX-X-X?XME-XBoBoEEE-----o-M?-E---Ev
-B-X?-M-B-MEXo--XX---XX-EX-?EEBEXXBBEXo-EEE--XoBX?EXEEM-o-EBXXBXXX?oXBXooX-XEEBEEX-BE?-E--oB-o-?MBoE-E?--EB-EXMMXX--EoE-XEEBoEo?XXEo--Eo--XXXX--XXBXXMXXEXBEEB---o---BXMXX?o--EE-XXX----M-E-------o-o-Ef
--X-XBMEMMBEX---oME--X--EBoE-XX--M?XE--?BE-XEo--XBBE--EBB-oEXE?EX?MBE-o?-B-X-BX-o---XXX-EXX--XXoE-XXE?XoXXEM--X-X-BXo-EX-EoE--BE--oXBE-?B---MMoEEBXX-X--XB--E--B-B-EEEBX-oE-EMoEEX-BX-XBEB-EooEXE-----?f
-BXE?XE---?--MX?BM--oXX-oM-X-E-??XoXE-EoXXEXXo-oEBXXo-EoBE-oXoBX-oEXXME--XMBM-EEEXBBEooX-oXXoEB--X---EoE-?MX-MXX?o-?EBXBXEE-M--XB-EME--o--XE-MXMBXE-EEX-XoMEB-EM-XoE---?Eoo--BEEEBEE-EEX-EoB---XXXBMEE-f
-XEXM-XBX--EXEX-M--BXBEo-o--E?EX-EEMMo---ME-?B-----B-EE--X-?E-X--?BXE-MEBXXEE-EoXEEo?BEXXooE-XX--?--oMB--X-EXX?EEEME?--XBEooE----EEXB----XXX-E-E--oEoBB-BXME-XoBX-o-EXo-???-?oEXXE-MEXoEXBXX-oXE-EMBEMBf
-E?--o-EX----XX--XMXEXEB---?EE--oE-XXEEEBXE-o-MX-XM-oEBEBEBEEEo-ooXXE-MoEX-EX?-E-EoXXXE-EoEB--o-XEMXMoXX-EX--EE-o-EMoX?-XXM-XMEBMXBB?-MBB-X-E?-o-o--EXB-XMME-MEMoE-XX-?o--?-M-E-X-BXEM-oMBXEEXEoXMEBBX-f
-XEo--MX-EME-o-E-X-?X----E-E?XBBX-oX-MMXX-Xo-B?--BM-EX--B-XE?-XEX--EB-Eo---oE-X--MXEXBEEo?B-XEXE---oX-?BXE-XE-BE---EEXMX-EBE-E-oXo--X??BEEE-?o-MEo--B-XX-BXo-M-oXoX-EE-X-XXXo-?MEE-o-BXXE-E--?EEEoXB-E-f
m-XXEE-BE----X-BBB---B?XE--X-Mo?XEXoB?XE-E--?EB?-XBX----X-XoE-EXo-EEBo-B-o-XX-E-E?E-o?X-?E-MEE-o---EEoX-E-EX?--MEE-EEX-XXXE-BE-BX-?-B-EEM--XEB-BBX?EE?o-E?EEoB-X-XXMXB-E-E--?-B---XXEBXEBEE-XXX--X-EEXoX
X-E-B--E-BEoXX-BB-BX--?oEX---X--EXBXX-XEEEBEBo-MX-o--?-oEXEB-EE--X-XMMX---oE-E-EB?EMEXoE?-XoE---?---o-B-X-?XXEX-?-X-XEXEBX---EMX-BX-Eo-oEEE?EM-XEooM?E--BXX-oXEE-MEEB-oX-MX-EMXX-E--M??oXBXXXM-B--oXXBXX
