---MB----XM-oXB?-E---M--B-o-oEM-XE----XE--M-o-MM------E-------X-?XM-X-----oE---M-------M---?M-E-B----Xo---X--o-------M--EX---o--B-E-XX----M-E---M---?B------o?------X-E--B--E--E--o?--------?------Eo-E-
--M--?--XBE-?M---?-X-ME-----?M--?-M--BM----M-----?B--E??--B--o--M-----------?---E---EM--------------X-B-----E--M-E-o-E-MX---Eo-?-E-EXB--BM---Eo-?-----E----o---E--MXo--?-------?--o--------?--E-X--X----
-?---o?-B-E----B----o---E------------E---BEo-MB-----------?-M-B---?-M---E?-M--E------M?--------o--?MXB---?-----E---E?----E-MB-----X?-M----X-o------?E----o---XE-----MEEE---?-M------E-----E-B-----------
-MX---X--E---o-M----X----E---?--X------E---E----Bo--o------------E---M-o------------E?E?-o--M-M---XBX-------o------?--?-X---o------?-----B-----EMEE---o---??B---B--X-BX--B-B--E---B-B--------------B----
----M---B--X-M-o----B----X-?-----M-M--??-o-o-M-B--??---------E------M---B-----XX-E----------?--X----X--M-M--E-X-----Xooo---E-------M------EM---E-------?-E-Eo-----M------------o--MB----o----o-o--------
----B----------o---------B-?---------X---B------B----?o------E------o--M?oo-o--E-E-----o------X--?E--BX-----?---M----B-BE-?--XXM-----MBX-------X---E--XM---XX---X-X------B------------E-B----E-M--o-----
--------?---M--XM-----?---Bo-B-B---o--?E-----------XB--E?---MXB-----B-?----XM---------X-----?----B--------------M------?---?-----?-M------XM----B---o--oB----E-EMX--?---E-o-X---?M-------?o-B-?M----o---
-----B----M?M---M------?---EXM-----E---B--------------XX------?XB--------B-EB---E--------------M----M------?X--M--M----o-?--M-------BX-------BMM-------B-E-oM-B-o------------E--oE-M-E?MB?-o-?---X----Mv
-E----M---BM-----o----------B----B-----X-B--?------X-Eo-----B------?-E-E--X--E-------?E-?BM?--BM--?M-----?M-o-EE-?--E-----EE---B--M-E-----B---o--E----o-B--oBX?-B-EoX---?------------X------X-X-M------f
-X---?---------------B---Xo-M------X-?-X-?-o----X-----oMo-?M---B-B--EM----?-X----?-X-B----B-M-M--?-------M-EX-----B------B--X---B-----E-?-----o--?M-----o-BBo------?-----o-----o-BM-Mo---B------M-o----f
----B--E-B----?M?M-X--B---??-X-----?-X-----oo--MM-----o?-?o-------------Bo-----?B----o--------?---?--E------------EEM---?--?-?-E----E--X?---?--?EB--o-E-?---------B---?---------o------------------o-o-f
-?------------XX----?-----------??-------o---B-X-?B-----------oMo-E---X-B----?-oEM--E--BX-o---X-o--------B--oE-?EE-------X---BB------------E-----E-E--------?-EX----?---o-o-------E--E?o--?M---?----X-of
-------?-o-o----o--------X--------M----E-M---o--------M-??--------B-M?--?---o--E-X----E--E--?-oX-?---XEB-E----X----o-------?B?---E-BX---X-M-----B---o-----?----?X?----?--E------------o-----E-E-BM-E?--f
-E-Mo-------X--X----?----X---B-----B?o---XB------M-------XM--B--E-o-----------E---?o---E--M---------XE--------XM-Mo--------E--o--B-----------E-----XB--Bo-----??M--o------?-BM---B--XE--X-?----?-M--E--f
mBEM-E-BB-o--M---E-?---X-E-?-o-----E--E--B-M---B--------B--E-TT------M--EoT-X--------E---B---o---M---?----Xo--o----?--o-----X--------BM-----M?XX----------B----------T--?--X-?T---M-?----X--B----B----BX
XXXXBoXXXXXXXXXoXoXXoXMXXEXXXMXXMEXXXXEXoXXXXXXXXXXXXMEXXXXXX||BXXM?XXXXXX|??XXX?XXXXXXXXXXoX?XXMXXXXBMBX?XXXXBXXXXXoXXXEXXXoMXXXXXXXXXXXXXXooXX?XXEX?oX??XXXoBXXEXXX|XXXXM?XX|XMXXXXoXXMMEXXXXXMEXEBXXX
