--?--M-oXo--M----?-E?oB-?---XX---X-X---B--XE-----B--BE--X---?EBX---------oX--oB---X-B---M--------X-M---E--X?EX-------oX-----?----------M----Xo?-----o----M--Bo--BE-XB-----oo---?--E-B-X-XXB-?E-o-?-X--B-
-----o?----Eo------?---E--BXE---XXM----?--E-X--EM--------?M-X-?-B-E-XMB---o-o-------M--X--------XXX-M-M---E--------BE-----BX-?----o--XM------M--?--?XX-----M--E?-?B--EBE--?------Bo---?-?-?-X----M-E----
-------?---X--X-BE-----Xo--XX-o--M--?---o-E--EE----E--BMX-XEXX-E---E--E----X--X-BX---o-EXXoX?-BB-M-----X---BM--o-MX-------o-X--M-BX-X---??---o------?BB-oo--E-----------?-o-----MXE----Bo-----MX---B----
--M--?--?-----X---BX-------X------M-X-B-----M----M??-EX-X---?XM--------o-XX--M--E-X---X----------------M-ooo---E--oM--B----E-?-----o?----XoB?----oX----B----oM---E-M-----X---X-B-E-XXXX-EEX?B-o?----EX--
--X--BX---E---o--------E-------oE---XEMMB--E--X--X----oE-----X-X---------M-E--o-?-E-o----B----Eo---------X-B--E--XX?o----XX--EXB?-B-------X---E-E-X--o-B--oB-----------M-----X--E----B-M---------oM-Eo--
-X---M?XX--?X---o--E--------X-XX------o?--X--o----E-M-o-o-M------X-?-B-X----E---M-X------B--------E--Bo-MX----?MEMX?EM?-X---B-------Bo-M---M-M--M-M---------E---X-------M-o-XM-?----BBBB?-----E--B?--?--
--XX---MME--o-X-----E-BoB----?--B--X--EE-X-X??--M--B-------?B?o---XE---oBX-E---X-B-XB-E------XE-X---B-------?X---M-B-----E-X?o-E-o--X-------X---------o--E-----?-o-----E------E--?-MEB------X-------M---
-?-oX-M---XEX-E---B?-B-----X-XEXXX-BE-o----X--B?oE-?B-M---BBX---XBo------EX------?oE-oE--XX-B---Bo-------o?M----?--B-EM---X-XX-?--?XB----------X--X-EE?oo--------M--E---BX-o---MX-o-EB--M-----X-E-EBBo-v
-oXB-----B?-MXB---X--?----XX-EX-o----XE----X--BB--?-MX-X--M--X-?--BE-M------oB-o-X-EM----X-XX-----B--?-?B-----X-MoE-X-EE------M--EoXB--E-------------X-?-------M--o-B---?XEX-------MXo--E----M-o-oBM--Xf
---EM-B-oEE?-E---X---B---?---?X-X-X---EX---B--E----o---MB--XXX-------------M---------EXXX-X-M---?--X---X-----EX-o-M----E------E-?--BE-oEo---?-BXEX-----M-X------EX------XM-M-?B-o-MB-E--E---X-o---?---?f
-M--------XM---------M---?-E--E--XB-------X--B-M?X-?-M--?---------XXEB?-B----X---?E--o---XX---E?----------E??BB-M----B------M---XM--E-B--BX-B?---X-EX---?----XE------X?----?-M---M-M-?E----XX-Eo-B---X-f
-BX-X-------E--o---B-o-X--E------B-------oMX?E-B---?-E-?--?---------X-E?X------MXM---E---X-M----X--E---XB---E-B-----EXE--?X--EE--?--M?E?X-X--EMX-B?--?----B-X-XX-Boo--M--MXo-XE-X--o-o-----B-E-----XE--f
-o---X-?X-B-M----X--B-----E-?------E-X--?-X-E---o----X--X----?B-o-------o---------o--?--M----X-MB---BB-X-E----B-----X--MX-----XEXE-M-MB---X--?------o---BM---?-----o-BMMX--E----B-X--B-?-o-B--B--M-M---f
--------?-o-XooB-BB-XXX-?X--?--X-o----M-X------X----X---Xo---XX-X----X-M-B---?-----M---EB-X---B-BX---?-o--XMX-----X--XXEE------XBo----?-------M?X-MX------M-E--M-o-E-XoX------XM-----E-M?---E-E-?------f
m-----------E-?-M---?B?X-oM--?---XEo--------XoM--?------------------EB-X-----Mo--X-o--o-M--EE--E-o-------XMX-----B-X---X-X--E------X-X--BBE---M?--X--XoEB---?---X-o-----X-X--X---Xo?--X----BB-o---o--E-X
XXX----E--XE-----?-E-MB?Eoo--??XX---o?----X---B----E-XBo--E?--BMX-?--?---B-o-Xo-o--?o-------o------?----?----o-M----B---BB--E--?----o----X--------B?--M-------X?-?-------B-----X-o--o?----E----B?-?--?-X
