-Eo-XE---EX--BE-X---oMXB-?E-EoXE-BMX-X?XoEE-X-XEB?--M-oMBEXX-XXXE-EB--M-oMo--B---B-ooM---Bo?oEoXM--?BBEXBM-X?XM--XXMEB?-X-M-XX-EE?EX-B-E?XXoMXBX?-E-BB-B--o--o-BBEB------?X?X-X----oX-E--XBX-B-XM??-ooE-
--XXEEXEoE-XX?---XM-B----oE-?X-EX-o-B--o-E-EE-EX-E?oBX-?B-XoXXoBoXBoB?X-M-EMX--E--oB-o?-oEo-XME-M----MEX--ooo-BM--XEMB-XE--XEB-EBEE-EX-oo-M----XX-XXXXXoE-MXE-o--EXEX--BX--XXoXX-EXMMoBX--E-EXEX-EEB--X-
--EXEEEXXXEoX--XXXX-BXEBBo-E--MEEE-?oXMXME-MXEEoXBB--o-E-XE--E-EXoBooXE-o-o-XXo-oM-EXEXBX-o-o-Eo---EBX-B-o-EXo-EBEEEXEXXEEB-EEBX?X?BEXoE--EXB-XXoXXo----MBo-E-EXE--XB-X--ooBoEEB-EM??EB-XX---?B-EE-EBMM-
-E-X-M-BMo-XEE-X-o-E--BB-?XEEooBXoE-EEEEXEEoXoXXEo-o-E---XoX--BE-B-o-B--oEEX-EoEMX---MX-XEEX-E?oBMEoXXE?-E-XBXEoEXE-E-XXB-X-MoEEX-?EX-----B-MoM-X-MEEEXEE?BXXXXEX?-EXMo--ME-EXEEEE-MXMEXo-----o-E-XE--?-
-BEXXo?oEXXX---XE---EB-EBB--E?EBE-B---EEM---XM-BX--XXXXEEBMB--XEoEoXEoEEEEMBXX-X-XBoX--XX-oE-XB-XB?--?-o-ooE--EBoBMX?X----M?oE-BEE-ooEXBB--EX-oXXEB-B-XBX?oM-oXBBXo---EE-ME-oEX---X?XE-----XEBBB-E-XBEB-
-?X---X-EXX---EB-B?E---BBBX?X?EM-EB?EXE-B-XXoBMXE?BXX?-EE-XBEoBBE-BE-MoEE-EXBEX?o-E-E-E---B-XXoEBEXX?BBEo-o-MoXBMoX-MM-XBE-EBB--oM-XX-E-EX-X--BEE--BB-E?EX-??---??X-E-Xo---EoX-XX-BEEE-oooE--XXXBE-XE---
----?--X----EXo--E?X-EXMXX?XMEEoXXoEXEBoMoEEX--X-oEMXXEM-EB---oEo-EEBXXXBX?-EE-MEBEXBE?EEooooooBMXoB--Xoo-o-XXE-???ME-EMo---o-BM-----XX?--EEXE-XEEEX----?E-B-E--oXX-?-XM-XX--?-MX-XBBE?-oX-XEB-BE?B-XoX-
-XEXM--BXXMoo-oE--E??--MB-MoX-E??o-E?M?EBE-?XX--X-o--MX-BooX-Bo-BB-E?EM?-M---X-B-B-BXE-o--EEoEMoXEoXMBBB-ooE-E---?o-XXMXEEXoEEEEEoEoEXE--EEXoBE-E--oBBEB-B--MBX-oXoBXBEXXX--oEoEEBBM-oBX-BXEEoB---X---Ev
-X?MEXEo-B?MX--?-XXBo?oXo-?E?MX-BX-EXBE-?XX?E--EM-M?XoEE?MoB-?-EE-?EX-X-E-XMEXXXBoXoX--EE-MXE-?oEXX-o--X--EX-E--XMoXBo-EXBBXXE--E?----EXXXEEoooX-X-MX-BXBoEXB-EX-E-EXoBBoXE-XEE-oo-?XXEE-B-E-XM-oB-EB--f
-X?EE-X-X-B-XMB-B--oBXX-EX-o-EXX?-XEB--oE--X-XXXXo?o-ooXoM-oBEEXM-M-??-E-o-XE--XBMX-EX?--M-oBBEEBE-EEB-E--oXX---XEX-EM?-XBE-EXX-EX---X----MMM-XXEEMB---EEXMo--EEE--X-EEEB--o--?-XoEEE--B-X-E-E-?-oX-XMEf
-ooXX---E?oEB-XBoXXBoM?EE-EB--XX?-XEMXBoEEEo-X-MX-E-Xo-?E-Xo-?MBXB--EMXEEX-E?--EEXoX---B-EoEBoXX--XE-o-EXEE--BBME-E-BoX-X-X?-ME-X-B-E-X-BX-EX-B---BXXE--EoX-EBB--E?B-EX-Eo-EEEM-Eoo-MEM-E-B-EXB-XXEM-o-f
-oEXX--oE-E?EBB-E?-oX-XXXoo--o-XE-o--o--MoE-XEXXE--o-EBEX-o----BX?o--EMX-X-EX-X-XEEEXEX-E?E?XBXE-oE-EoXXE?oooE-BXX-?EB-E-XM-X--?XBo---?E-BX-XEEEE---XXE-EE-EB-EBE--BE-Eo?oXo-X--ME--X?-o-EX--ooEE----??f
--?---?-BEE--oE?ooEX-ME-oE-??-o-MMEoX-MXX-BXEoX-X-?oE?oB?o-o--B------XEBoE-X-MEXE-oXX-XE--?---oX-E-MEXo----X----E--XEBB--E--E-M-XEXEBXX--XX-?BBEBBEEEE-o-B?---EXo--MEEB-XoB-oBEXXooE----ooXM?X---oEBEo-f
-?oEB-?EXB-MEEEE--E--EEX-o-XoX-X-Xo-MXBEBX-Eoo-Xo?MXEXXXXXXX-?Xo-EBXXEEE----EEXoE-o-E--o?BXBEE-X----BX----B-X-o--XoE?EBX-MEXBXoE-?ooEB---?EX-XXEBo-B-XE-E-B??oXoE--EBB-EBE-BXX--E-Xo--X-MoBoXEMMEEBo-E-f
mXXEE-XX-E-X-EXX-----E-B-XEXBEX-MXEX---Eo-EX?XXX-E---oXX-XM-XoEMBME--X-M-EXXo-EXBEEoE-E?BoEX--BB--BE-XEX-oE-XoX?-X--B-XE-?-XoEEX-E--o-BX-XB-XEBX-----E-XooMo-XXMX?ME--oXEX-XXX---BEE?--XEEXBM-M------ooX
X-X-Xo-EEEoE-oEBBX-o---EB-M-----EX-EEXBoM-XXEMX-EEE?BXE-E-EoEXEoXBMBBXEE-E-MMM-EEEE---XMo-BM-?-?B-o?X?M-?EM-BXo-oEEEB--XX-B?oXB?-BE-B-oMEEEXEX-E-?oB-?oEB--EoXE-BMXMoX--EEEEM-X?----XXBEEXEoEXMXo-o--B-X
