--MB-E-XXEoXXEE---?X-BMXE--BBBBXEE-oXoE--E-EBE-EoEEE-?-X-EBBE----EE-?EoMBoEMX?-o-B?EEXBX-EBXEX--XoEo--o---MBX-XE--BBEEoM--XE?E-oXX-oo-E-XXEEXXXBE?B--XMoXEMEM-E-EX---oX-E--XEXEEMXBE-E-EEo-EB-----XXX-?-
-EooXEX---EEMX?-XXB-XE-EX-B--XXoX-XMX-EXEEXBX-EXE-E-E-BB--E--XX-Xo-XEB-XMX--EBBXE----EEoEEEEE--XEE-E---E-?XBo-oo-EX?-BEXEXXEMBo--E?-EX??X--BXM----Eo--?--EMX-X--?XX-BXBEM--EMMXBEB-o--o---XXEX-X--XMEXX-
-?EE-X-E-o-?XBBE-o-XXXEEEEoEXEX-E-XXB-?-M--X-?XEBEXoE?XX-o-E-E-BXXXMEoB?oBEE-X-E-E-XEXX-XEXEE--XXMXB?XBXoMXBEo--?EXEXX-ME----EXBBoXEXBX?-EX-BMX-BEEEX-XX-o--?-EE??oX-BoXXXXMXoM?BoXEX?oB--Xo-EEo?EE-EEX-
-oo-MEX--E--X-E--B-X-Eo-o--BX?-oE--XXooEEE-EXoM-oE-?EE-EEMXXM-oEEXEX-Xo--X--EXo?B-M-E-X-X-Eo?BXEB-X-XXEBB--E--oEEME-XMoEX-o-?o---E---o-oo-Eo-?BB-X-MBXX?-EBX-E-Mo-EM-B-MEE-EooE-oBo?X-XX-EEo--EB?BBoEXo-
-X?X-EB--oB?M?BEXXXo-?oE-XB-EE--X-B-EEEEX?-XM-EoM--B--oBEoB-B-EEEoXXE?-X-oEE-EoXB-Xo-BB---Bo-X-M-o?-E--EEE--oE----XE--B-EE-E-X-XB-B---XE-o-X--oEX?-oM?-E-ME--M----XX-EXE-E-o--o---EE-XXoEME-X-EEE?EXXEE-
---M---X-E-XBXooEX-BXoEMX--XX--B-oo?EEE?E-EX-oXXBE-XoXXX-BE-EooBE-XBXE-M--XXoB?X-ooB-X-E-XXXEX-X-EXE--?MX-MoE-XXE--?EEoB-EE--oEoXE?X?--X-oXB-X-E-?EXEB-oEBBX--MEEoB?oX-XXXoB?-XB-X-B-?MEBE--E-EXM?E-EX--
-EXE?ooMo-X???BEoooE-EEE-XE-BBEBEB-E?-E--B-?---E?-XB----X-EXBE-M?E-B?oX--EEE-EEM-XEoX?XE-XM-XB?XXo-XXEEoX-EX--X?B-XX---B-BXE-oBMXB-EEo-oE-MB---EE?X---o---?E--BBBEBEEEXEXXXE---B-XMMB-E-?E-B----B-EoEE--
-oEBE-XB---X-B?XEB-EEXEXXEXMXooXX-----MEoX-XMXEXoXX-?ME-oX-E-BBBXB---E--X--EE-EX-E--E-oB-o-?BXE?-E-oEBXoMEEXX-E-?---?XB?E------?-EX---M-XE-E----oX-M-EMEXEX-?X-BEEXB-oE-EB--XB?B--BXXB---?MBMoB-EXoEB--v
-XXE?E?o-EEEB-----EE-XX-oE-E-EMo-X-XX--X???-EX-EXBXXEXXBX--oX--XBo-oE-E-E-E-XoEE-E--XE-XEoE-B-X-XBE-XE-E-MXEE-E-X--XEE-E-XoEXEXXEXXEM-B-EEoE-o---?-E-X--EEEXXEoEEM-?M---B-XB-E-B-BE----B-BX-E-EX?--o-EEf
--X-o-B-XXo-BEoEEM--EBEEX-oBXE-?--EE-EXEB-EE-X-EXoXX-XBoBEX?E-XEo-oBEB--EXBX--EE-MEEXEB-oEXB---EEXE-X?XBX-EBEXE-XEM-EX-?XE--E-EB--o--XB-EXXX-EXE?Xo-XE-XEX---EBo-M?o-EE-E-B-o-EXo-E--o--?E?-X-BXE---M?Xf
-X-X??-MXE-oBoBXB-MEoBXEEoE-EE-E-XX-BEE-EEEB----E-oo-M-BX--E-X-X---o--XE-B--B?Xo-?BXXoEEMXEo-E-EEB-o-o-M-XEE?--X-XXEXEBXEBE--M-B-E-?-XBX-X-BXE?-EXoX----oBBo-MoEXoXBX-X-BMBX-XX-EX--XE-B-EoE-X-X-EBoE-Xf
-MXEoXE?o--Mo?-?---o--oB-X-E---Xo-XBoo-XM-EE---XEE-X--BEXBBB-XEM-BE---oXB-ooM-B?-B-X?-BXEoEo?--ME---XoEME-X?XEB--XXEEXB-MX-o--oMX??EMXXX-XEXoEXX-?-oBXXBX-B---EEBE-EEEo-E-X-M-?--?XX--oE-EE--EBXoE---o-f
-BXXo-EMoXXEE--EE--Xo-E---EE-BE?-EB-EXBXooEE----B-EEXXEXXXoBoEXEoEB-E--BXooBo------X-E-E-M-XEXE-XBoMMXBoo-oEXoEBM-E-XoXEB-B-E--E--o---B?Eo--E-X?Xo-EX?oE-Xo?B-EoXXB-M-MXX-E-EEXB-EXX?EX-ME-EoEXXXoEoB-of
-XBXEB---EE--?EXEEXEoBoE-BMEBEXE-EE--EE----Xo?B-M-E-EX-X-X--?oXEoXXXX-E?-?B----EXoM-BMXX---XBMXoBooE-MX-oEo?XEBE--XBMME---Boo-o-o-EoBo-BXXBEXB--oE--MEX-E--E?-ooBBBEXo-?-EoMX--?X-MEXX---EX--EM-XXoXX--f
mXEXBX-?BMXooEEE-oBE?-?-E?XX-E-X-XoB-oo---oXXEBE--XEE-B?-E-?XEE-EBX-----XBE--?EBE--E-----B?--B-ooooX-X-BXEB-B-o-X--EEBX-?-EB-BXB-EB-E?XX-o--oEXMXXX?BB-XXBMoXX-E?Eo-M--E-XEEBX--MXo-XXX-EB-E--X---E-EMXX
XXEM-oEXX-M?EEME--Xo-EX-X?EXX?E?---Bo--EB?-EXMEXBBXBEBE?E-XB-X?BEME-oX--EB----XXX-BXXXME-MB--E-oo-?o-?EEE--XX-XEX-E--X-EX----?o-o?EXEX--oXBM?oBXXXE-XEEB-X--XB-X-MEX-XE-E?X--o-XXXMXoEXE-o-BXB-X-BMBB--X
