---o---------------o-------------o------------X---------oX------E---X-----X---XEo---------Eo-------------X---------------E----------EE-----------EXE------------------o-----E--X-----X---o-----E--------
----------X---X--------------------X---X-----X--o--------o-EXo---o---X--------E----------------------------o--E-----------------------------X---o----E-----o-o---------------------X---------XE---X-E---
-o---------E--------E-----EEEE----------------X----------------o---o------------XE------------E--------E-X-----E-----------oE---------o--X-----E-------------E------------o--------------E---------o----
-----o---X---o---X--------X--o----EE----Eo----------o-----E------------o-------E--------o--X--------o----------E----------E---EX------------X--E----------o--X----E--------------Eo---------o------o-E--
----X----------E-----------o-------------E----o----E--E--o--X--------------X-----------oXo-X---X---------X---E---------o--Xo-------X------oo-oo----o-E--E--X---X---X---------------------X-----------X--
-----o----------------o------X--o-----o------------Xo--oX---o----XEX-o----Xo------------X--------o--X-----E-----o--------XE-X--------E-X--E--------X-----E--------------------X----E----X--E--E-----E---
-------o-o-----------XEXE-------E-----X-----o----X------------o------o------------------X----X-X------------o--X--------o-----X--X---E---E-----XE---------------X----E-------E-----X----------------o---
----E----------X---X-------X--------------------X-------Xo----E-----------E----------o-----------------E-X--------------E--------------------E--------o-E-E----E---E-o--X----E---X----o------EE-X---X--v
-------?-?---B-E--B--M--X-X-----B-E?X------X-?o---X--o-E---M------?M-?-----?----------M---------o-EB-B-XB------X-E?--M--oX?--------M----?-----------X-----XM-?oX-B---B--oE-B-o----B---BX--X?--?M-B----Bf
-oo----X--X--?---------B----E---o----EM?----Mo-E-?B----o?XM---BB---EXM--?------E-X------X-E-E---------M--B-----?--------MMX----?------M-----B-ME--oE?--o-B---------o---oo--------BBM--?o-M--B----?-B-BXf
--E----BEo-E-----------M-M---E-o-M-B-X-E----o-------o--------o-E----M-BX?-?--E-M--X-o--Mo---BXM----X-MXE-E--oEE?------BX----Xo-B-E-----M---B--o--o--?---E---------?-----B--?---BB----X-X---M-------?-E-f
-E--M--------------B-----B-----MBE?----E-----o-E-M---?BE-X---oXBE-----o------E---B--M--------?---------B-M--X---E?---B-Xo-X----B---M----o?-E--o-BB----o?---B------BX----XM--X---Bo-----?---E---M--E?X--f
-o---B-B------------oo-E---B-E---MX--------MB-M---M-----Xo---o-E-EX--XB---E-M-EB--oM--?X-------E--X--?o--MoM----E--?M----?B-----X--o-B-?--Mo---XX-E----?--X-o-?--o-BM---M--B-----?-?------B--X--B-?-X--f
------o-----X---M-M---M-M-----?-B--?o---BE--o--------------oX-E?------------?-----?---E----E--?--------?---M-?X--X--------XB?--o-MB-----X------XoBX-Bo----B-X--X----------B-E-XMM--------Eo----M-------f
m-?--oB--EEM-----B--------X---------XMX-----E--EXMX---------?----?XMEE-M---X-E---oB?----------o------B---MMB---oo--?X-E-----B---B----E-o-B--?-BXE---Bo?-B----------------------M--Xo-?-----------B-----X
XXXX?BBXXBBXXoXXoXXXXXXX?XXXXXXMXXoEXXXXXXXoXXoXMXEoXXXMXXoXXXXXXXXX?XXXXXoXXoBXoBXXXXXEXXXXXXBXXBXXXXXXXoXoEXXMX?XXXXoMXXMXXXXBXXX?XXXXXMMXBXXXXXBXXXX?X?XEEXoXXXXXXEoXXX?oBXBXXXMBXXXBXXB?BXoXEXXX?XXX
