?M------o-?---X--------M-------MX-?X-------o---M-E-o-oM--X--o-o-E-oM--o---XMX-B--M---o-E---EX--------MB?---------------?---E---E--B---o-E------MMX--E--------o------M-EE-MM-M-X----oBMBB-----M---E-----M
E-o----?--BX-------B-M--?------B-----------M------o--oM-M--X---?M-----------o--o----Eo---MM--E--o?M??--------E-?--------?-----------B-----o---?-EM----------------B---B?--EX---o-M-BX---B--E?M---XBE---T
E-M?-M-?----X--E---BM---?--o--B---B-MX-B-----EX--------------X-o-M-o--B---------?o----B--EB-----------------E-MM--XEM-------E-B--?---BX?X--E?E----M--M--XoX----?-X--B--------MM--B---Xo----B-?---?----E?
M-EEE?B-----BE-XM-MoBX---?o-----M-----XM---?------o--BEX-?-o-E-o-----?-------?-?--X----?-?E-?----EB----?---E-B?-o-Xo-----XB-M--M?X-o-Xo---?---X-o??EM----B-E---X-XX-----XX-E----E-M---BEo--?---BooMo---M
T--------??--?-----o---o-?------------EMB--o----B---M-o------------M--B-?BM-Eo?-?--X--X-----X-M-Mo--Bo--M-M--E-Mo?B----o?-M---EM--MXM---oo---o---?BE-----o------E--oo--ME-X------oE---EoE-?---------XEoB
|-o-----?---E--------B-E---X?--------o--B--M-E-?---X-B----BX--------X-------B---B-M-B---------BB---E-?--------B----?--o-----M--?--M-o--o---M--------------MB--------EMX--o?--?B-B--?-----M-E-M--E------|
E-X---EX---X-X---?---o-?X--X-X--X--X-ME?B---?-B-------B----X--------MM---M-BE--o----B-oX-----X--M---o-------M-B-M----------E---E-X-M---M----MB-B--?------BM-?M-M----E-o--X--------XE-M----?---B-o----B-B
E-------o--E-----?o----M--B-E-?-----?-EE-----------E--Eo----M----o-?EM?X---oM------B-----B-----------------o?B----------XM------M---E--E-B----?------?M-o-?----E---?-X---o--BE---E--o--E-------o---o-B-v
o-?oE-oXM?--X----EBE------------------BBo--B-------M-?E---BEE-E---------------------------o-------------EM?-E-XXo------M--B----------------?------o------E---E------X----X-----o-M----EE----------X---MX
B------M-XB?--------E----o-?---?-o----E--o----M------X?--BM--X---B------MXM-o----o-?----M----?-----------XB--M---?--M--?----E-X-EM-------------B--E--------X----X-E-Bo--o--?-X---Xoo-X?-BEBB?--M-E-X-E-T
|----B-o---------B-E-?---B---E-?E--Xoo----M-B---------Xo-E---E-B-X-M-----MX?----------X-----E--------------------X-ME-o---??E-B---B?-B---E--X---X---B-XB--?-B----X--X-M----B-EoB--E-M-XX-----E--X----X-X
---EMo-E------?XBM-------X--?--E-X--ooXo-----XXo----M-----B-B-------X---X--------------E-------?-XBX--?M--X-?E--o-------X----M--oX-?-----oX-M---B----oM---o-?--E-?M---B--XEB--B--o-BMB--------o-M-X-E---
B------o-M-B--MX----?--E-B-E----o--------?E-----?-M-----EM--X-------ME?--EE--------E-----EX---M-----M-B-?--B-M--------oB----B---E------------XM?Mo-?-MM-oo----B----o----E-E--E--BX-o-----M--Mo--------?E
o-E-------------X--------o---E?-M---o-BE-----oB---E----------Xo-E-oo----o-------M----o--X-X-----MB-o-------M--------MM----M?-------o-o--------?------?-?E----?---------XB-XB-------?---E-?--M?---o---B-?
m-Boo---M---------?o--B--E?----?-ME-B-XX---B----X---E---B-X-------?-------XE------E-X---E-M---BX-oE-BXBB-MMEE?M-----MX----X---?---B--X?--M----o-?E-o----M------B--E-o--X----o-B-o-B-----EX-XX-----??-BBo
XEXEXXXBXMXXXXXXXXXoXXXXXXXXXXXXXXXXXXXXX?XBXoMXXXXX?XXXBXX?XoXXXX?XXXXBXBXXMMXXXXXXXXXXXXBXoXXXMXXXXXXMXXXXXMXXXXXoXXE?XEXXXXEMBXXX?MXXXMXXXXXX?XoXXXXXXXXXX??XXXXBEXXXEXXXXXXXEX?XXXEXXXXXXXXXXXXBXXXX
