-EXMX?BM---EEMEE-B?Xo-BBoXME-M-EX--oX-XBX-MMB---?---X-oM-M-M-EoX?Xo--E--EoMo-oB-XE?XXoEEXoEB-?B---?--M-X----oXX?E-XBX-E--E-B-Eo-?XE-EE-E-?--E-BXX-MX?EXX-E--XB-B--XoE-?X-oB---X-o--Eo-EBEXXXEXBMEME--BX-
-EB-EEXB-oXoE-XBEXo-E-o--X--E-MB-EX-Bo--oEXB?EE-XoB---XX--E-EXXM-BEM??-MXB-XXEX-E-B-E-oE-MBX---?--o-oo--MXE-?XEX-XX-X--EX-EM?B--E--XooXB-X-?BMM--XXXBXXEXBB?XEEEB---o-M--oEEoEXEEBEoBBM--oXoo-MXBBEEEE--
-MEXXBE--XEE-XX-XBXEB-X-o-X--EMX----BX--oXE-MXMX-XEBEMBBBMXE--oo-X?oo-E-E-B--E--E-B-XXoEX--?o--E-E-o-E--XEX?---?o-M-BMXMBMX--BoX?-B-BEX-Mo---EEo?EMXEXXB-EE-oB-XEX-XEX--EEB--BXoooMEEXXXX-BBBEXEB-EEX-?-
-Eo-oEEEEBoX---X-BE--X--B-o-EE-BX-EX-oo---EMX--BoB-XoXM-EX-M-XooBXoEB----XEXXXXoEEX?X-EE-X-E-X-?-XMXMX-E-EoEooXB---MEooBBXM?-X-?-X--oMXoM--XoE-EEB-o?EoBXX-M-E--ME-o-X-?o----X--BEEoX-M-o-EE?B-oXXEBEE--
-o-XE-XE-?-XXoB-----XXBE-EBXB-EEo-X-BXMEB---EoEXXoE-E--XXM-?X-oXEB-oBXEXX-oBo-X-E-E-Eo?XX-X-o-XBXB-EBo--E-E-XMoXo?E-E-BEoXEE--?X?M-oBE-Eo-EEX--XoB-X?EEXE-XX--E?X-ME--EBEEXoXXMo-M-E?--oMB--X-?XMBXBXMM-
-o-X-XX-E-M-Eo?XE-XBE-MME-XBXE-BXBXBXB--X--XoEEEXoEBBo-oEoBX--B--E-X----X-BXXBEXXEXXXX--XEMXEBXMB-B-XoXE---EEXBBXXXX-XMoEo-B-E-X--ooXBoEBB-?-BEEo-oE-BBBBEBBoEEEMoEoE?-BXMX-EoMX-E--E-EEMXXB-oEB-EX--X--
-B-?XoXBoBXooB-XoM---XXEooEX--E?BB--oEXEBX?X-oBE-E?-o-EXEEoB-EEXM-XXXE---X-X--oo-?--BXE--XXXE-BoXBE-XBEB-oEXEB--BMXooME----BX-oXoEoEEX?EXEX---o--E-B-EB-X-EBX-oEEEoBEMEB-------X-Xo-EoB-M-oXXX-EXMBXoE?-
-E-BE-M-X-o---E-M?-BX--EBE?--E-E-B-XEBBBEo?-BXXoM---BBEEXMXE-B?---EMXEXXoEX-E?-XXX?X?B--E--BBoX--ooE-EX-?M---MEXBMoBEE-E-EEEM?--E?EX?X---E-E-EX-EEBEE-EXBE--?BXX?X--X-XEBoX-EB-E--E?B----BEoXEEXE??o--Ev
-E-X?-XE---?--BEX-BEMXM-MoBXEXX--?X--XBE-XMXEX-B--oBo-XE--EEoXEEXMoE--BXBXE?E?BEEoo-XMX-?E?X?--E-M?-XEMooEX---Eo-X-?-XX-Xo-oX-EXXBXXB-EEEo-E-oB--X-EEEBoXoXEXBXX-o-EoBB-XX-oXXE-XEEXEXXEXBEM?-M-XoBEBo-f
--E-BX-EEXMEoo-X-?EE--XBMBXE?---XoEEEoX-XEMEX---XX--MMEXX?--E---E---X-BM-Xoo-?oE-o?Eooooo-EoEoX-o-BE--X?--EXE-XEBM--?-B-EE-oEEEo--?EoE-E?EXMX-EE-?-EE-E-BX----X---?-?BEEoEB-o-EXBM-X-?ooEXBB-EX--X-oEBEf
-ME-EBoB?XXXEE-EXXB-ME-B-XE-BoM?---E--EB-EoXEX-?BoEE-oBo-BX-X?-EXoXX?EE---MM-XE-B-EXE?-XX---X--MEEEXBE?--E-B-X-XBBXEE-BB-BX---E-B-BE---oX-XEEEo--oBX?X--XX--EXE--XMMMEoEEXEE-?B--E?BEXXMXoE-EEoXMXB-BB-f
--?BB---Bo-oEX-o--XE-Mo-BBXo?XEEo---EX-XX-X---XE?XoXM--XBo-oX?E-ooBXEooX-EEoXoBB-E-X-?--E-X---EXMX---oX?MXM-EXXo-BXEX-BE--XBB--EXXXEBX-B--XEoXX-MEEEBX-oXMEX-?Bo--XEE--EEBoo-----?X-BE?EXXEoE-----?XMoXf
-oEEEo-MEo?EEXXEXoE-XX-X-XoE--X-oE-E-oB-E-?o--E----MX-E-ME?-XXX?oB-XoM--E-EXo--o?BMBXB-X-EEEM-E--EXEoEBEXEXo-o--EEEXB--X-XE-EE--E-XXXooE?Xo-XEEXXXEE-E?--B-EX-B-EBM-oBB-X--BoEo-o-EE-o--BBE-EE-E-XoEXE-f
-o-XXoE?-E?B-EE-EE--BX--E--EXXEB-EBXXoo----EXEM-?BXEo-EX-oB-o-EEXEBB---oX-EX----BX---oEM-E-?o-EEXX?XX---BEoMEXM?-XEX--B-BEE-EEBBE--EBXMEBEXE-MoXEEE-X--EXXEXM-EEEE?X-EBEEM-EE??XXEE?-o-o-oB-MB-BE?oEooEf
mEoXEE-XEE-?o-Bo-XEX-E-BX-XBB-EB-X--Xo-BXEXMoEo-E-B?E-o--B-EB-?-?o-X--Eo-MEoXoo-o-BXEXB---o-o-EB-X-BEEEX-EBBEXE--EX-E-oEo-o-oXMX----EM-oB---E?o-EoE-oX-X--EE-EXEoMEB-XBBB-E-EEB-EX-o-E-----XoEX?M-E-o--X
XE-BBXXX-BEXE-BEMBXBE-X-EBEE-BBE-EEE-???X-Bo--MB?XX---XE---oX-B-X-X-EXEBo-XEMEX-XB-EX--EXX-Bo--MXE-X--?--X?XXMX-E-BME--o-EMEXoBMXo--oX-XXoE-E--XBXX-----X-E-BoE--?-oEoMXXBBBB-o-EMEXX-E--XXE--?oXEXoooEX
