----X----?-o?----MM-?-oM-----E---M-X----B--o-o----?-EoBM-?-o-B?--------o?E--M?o-----EEBo?-E-----?---B-E---M----o-------oXo---o--?-------B----M-----o-X--o------E?--?--BB-----o------BB-----EB-----o-----
-MM-o------Xo---o----------E-------BM----B?--EBo--X-E----------MX----o--------M-------oMX--X--oB-o?--?------B?B-----------X------B----?--oE-XB---?-----E-B-E-oEXoE-----?-MM----B-----M-----EoM---X---E--
--?------E----------M--E-M----Xo---oB--E?---B-------E-B-M-----X------E--?---o?----BX-B----oE------EE--X-Mo--------?-E----Mo------?------X----?M------X--E--EXM-----M-?B-o---------M-o--B----MMM---------
-----?-B-B--M-B-M----------?--------------------E--?-o---E-------o-X-oX-MME-BM---M--?-o--o-E--Xo---E---E?o-MB-oB----X---?---------B--Bo-?-E-E------Mo-----MX---X------o-XB------------EM??-----X---oE---
--oXX-?-BE-X--?--oEoo---?X-?M-X----EM--?-----Bo----o--B-?-?X---o---MM-X---E--M--X-X--X-------X-MB-oXE--M--?---oXXB-E-------XX-----X-XX-B---E-M-----------------E--B--o?E--------E--oMM--X?-EM--?--E--o?-
-o--M------o----XE----Eo---B----X----B-----?--------E----X--M-B-----------E----o-------M?-----E----X---?--B-M------??--M------o-E----MB-?----?----E-o-oMB-MB-X------?------M--------M?B----Bo?M-M?-XB---
-M----XM--B----E-M--B--X--?B-X?---E--E-X--o----?-------X---?----M--o-X---B--B-------------?X------E----?--E?--B--E----B-?-----M--?-B-X--X--oM?-E--M---o-------o--X?--M-M----EM--Mo-------EE-X---XBE-----
--X--------MM---Eo-o-E----------M--X---M--E--?XX--oB----B-----E-o-?MMM-?E---B------MoB---?----?----Mo--o--B-BEB---MM-B-X---o---E-XM?-Mo------o--------o--oB?M-E--X-----E-X-M-------X---M---B------o----v
------?--M--E-B-X-?-?-E---o?------EoB--B?-M-B-----?-E---M--o-X-o-o-ME-----B----------E------M-X----?------X--o------XE----B-?-E--o---E--EEB--------E---o-----EM-o-B-M---?--o----M-X---oB-------X---B-?-f
-----?---E--------X--?---BE------B---o----B---oM------------X------E--oX-----?------------o-----------------------E-----------M-X---Xo-M---E-----?---?X----M-X--X----MX--o--E-E-X--M-----M--XB?X?---?--f
-XX--?-M--M------------X--X---?-E-----X?--X--B-X----------E?oM----B-X-?-------M----E-B---??-----M----BE---o--M---X-M--------BM-?o------o-?--o-?----E-B?M-M------B--------X------B-BB----Eo----?M---MB-Ef
--------?--o--------o----X--X------M--X---E---?oX---o--o----E-o-------oX---o?X--M---?----X---X--Mo-------E----E-E---X-?-B------?-M---EMoo--BM---X----X------E--X------o--BXM--?------E--------------M--f
--M---E--M-M--MB-----?--o-E----o-X?---B--------?--E-----o-o-----B--M--X---M?-E-----ME-?---M-ME-------B-E-B--o--X-EX----E-o-EM-oM-------?----MB--E??-?-------?M-o--Mo------B---?E---M--o---M-----EM---B-f
-------?-?-----B-BB---E----B----E--X---?-?-XM?M-X---?----B-o-------B-o---M-o?---E---Eo------------?----o---?----------o-------------o------X----M--------?Eo-X-B--o-X-M----?B-X----BBXB-------?--B---?Ef
m--------EE-M---o--Bo-------E--E?-XM---E-------B-----XX---B--B?-?--Mo--X---X-X-??X---X-------M?-E-X--B---EM-----------o-o--X----------XBB-B----o-M-Mo-X-o-?-E--B-------------o---?----o--------------XMX
XXXXXEX?EXXXXXXMXXoEXXXXXEXEXXXXXXXEXBXXXXXoXXXXXXXXXXXX?BXXXBXXXXXXXXXEXXXBXXMXXXB?XBoXXoXXXXXXXXXXXXXX?XX?XXEXXXXXXMXXXXXBXoXXXXXXXXXBMXoXXXXXXXXXMXXXXXEXXXXXoXXXMXXXXXXXXXEXXXXoXMoXXXXXXXXXXoXEXXXX
