--E-X-M-?BE-X-Mo-E-BE--?--E--M--BBB---E?-o-X-E-XEEXEoEo-EX?X--EE-oEM-X-XXMBM--EMX--BXBE-ooE--?E-BX-o---oX--B-E-BoEXXE-XMXBX-EMEBX-EBX-o--E---?EXEMo--o---B-oBX-BoBoXXXM-EXX-BXE-XXB-XXMEEBBoBMX?-MB-XoB-
-M?B-XXEBE-B-XX-BX-E---BB----o-oEXBo-o---EBX-Eo-X---XE--MXB--?EXX?XooBE-E--EEXB--XX?B??XBBEEoB--o-oEoXB-EXXXE-oX---EBXX--?EXEX--BX-oXXo-EM----B-X--EXo---BEX?-oX-EoX-o--?-?XBX--oX-XBXo--XX---?BEo--ooo-
-EXE-XXEX-XBoo-XXo?Mooo??X-E-EEEX?MXM-M-E-MXBBEEMMEX---o--oX-EoEoBE?o-BXEB-X--oBE-----Eo-X---EEE-XoB-MXEEMoEXEXEEX----E----?E-ooE--BoXEXEXX-o-o-?XEoXX-oXEo--XEMoMEXE---?EoMM?-E--B-E-X--MEX-Eo--B--ME--
-?X-X-MX-XEXEE-oX-EXoBBoBX-?oX?BXE-oX---B-oXEo-X-XEBoXEXXoX-E-E-XEEXX-o?-XX-EoXBMXX?-EX?EXE-EBEXo-XBEE----BB-BXXB-EoBBXX-E-oBoBEoB-Bo-BE---XXXEoEEB-B-B---X?EEBEE?BXEoX-B-EXEEXE----oXEBE----X--X-BoX---
-oXEBB-XXoEX?oXB?EX----XE-X--X-EXX--XXXM-E-XBEXo-X--o--MX--EME-MEE-XEEB-X--oME---EE-XEX-X-Bo-MXXo-XXB?E-oEoXXEoX-B--?-?X---EE-XEB-?M-E--EEBXXEX-o-EBB-XEXo-XMEX-E-ooEEXE-EM?--ooXE--XEM-oB-ME-B-X-XoM-M-
---E-EEBX?E?E---E-XEEXM-X-EB-E-o-XX-o?-Mo---B-M-?oB-?oBEEEXEoXX-XXoE-o-BEXX-?BEEBEE--XE-E-EXEE-oMB-XoXXXMXEXEoXX--E-o-X-MXoBE-E--X-MM-XEX--EEE?XBXB--M-Bo----XE-XX?oEM--EXXMXXEo-?EB-XX-BX-oX---XE-MoXX-
--XBXX-E-oEXX-MM?-B-E?E-EXE--XX---EEo---XMEEX--BEEXXE-XBEXE-BXE---BEB---EXXE?EX?EX-EE-B-EBB-B--B-X-E-EXXB?EEXE-Mo-XM?X---EEBMEoBo-Boo??EXEo---EE?oB?-?oBoXoXE-EEEB?-X-MMEBBEXE-XBoooX-EXE--oBooEE---EEE-
---?M-?XXEXEEoX-MoEXXBE-X-B-oBME-EEEoEXX-EX-XEEEE-?XBE-XBXEX--X-EMXBXoo?E-E-MXEE-XXEXo---EXX-B-BXXEX-X--E--MBEB--XEM--XEEE-o-Xo?---XX-oE-EoX-XEEMB?-X-XE-XE?-BoEo--XEo?ooXB--BEEo-B-o-BEXXX-X--BE?EEBoMv
--o-XE--X?-E-Bo-B---o-----E--X-EEBEoX-oEMXB-?Eoo-Bo----EX-X-M-BM?-BXE-EXoE-E-XE--EE-XBX-BE-E-?XoB--oEX-BoEX-E?E-B-EBXB-oMX--EXoXEE-MoXME?oEXXXX-?X-o?E?oB-XBB-MMMXEXE-XE-oEEMEBEEXoEoooEo?-o-?XXEE-Mo?Xf
-XXE?E-E-XB-oXXEoo-E-XXXEoX?-B-oEX-EB-EX-XXo-BEoBX----X??oE-oE-BXB---X-X--BE-EM-Bo--o-EEEXXX--EXMEXEXo--?-EEoE?-BEX?XE-X----?BXX-XXX-BB---XXEEEXEBBoXEEXMB-XoXEEoE--Bo?Xo--XoX-XE-X?EXXEEBEEXBX-------Ef
--BE-EX-EXB?XX-EXE-X--XE--EoEBB-EB--XE?X--o-oEEX-o--Eo--?-B?oMX?o-EEX-o-oo?B--X--ooX-oMBE-B?----EX----XoE--EEX?XMXEBoXB-o--oBE-B-XME-B--MX-XEEX-X-?o--X?X-oEX-XXo-XEB---E---B-XEoEE?Xo?EBEE-B-X-XEoEoX-f
--oXXo-?EXEEEXoBEX?XB-EMEM-?oE-B-oBE-X-oXM-?-MXX-XB---EEEo-XEXXoB-E-?-XXX?--XEEE--XEo-EX--Eoo?--?EBBEXE?EBBBoXXX-XMEE-oBX--XX-XEXXX-EB--EBo?XEM?XEEoXoXEEEXX-MB-XEEoEBMXEoo?E--MXEoB-E--o-ooXo----EX-Mof
-X--X--Xo-BEX-B-E-X---BXXX?E--X-X?X?--E-XE--X-?---?EEMMEBEXE-B-XXE?XB-Xo-E--oM-XX-BE-B--?XB---X-M-?MXB-XEBB-?-XXX-?BX-XX-EE-BEE---BEBEXB-X?E?X----?oX--XEoE-X?-EX-o-X-oB-o---EBX-EBBME-XXE-?X-XEEX-MEXXf
---X--XXEEX-BX?X-?BEXX-Xoo-BBEEEB?XXX?-?oEEX-X-E-XXEXoE-Bo--?-----EBXEoXMM-X?-o-oEE?X-XBEX-XE---EXBE---?X--XB--EXBXBEEMXBX-MEE?EEB-?---Eo-E-XM-oEXXXB-?-XXM-EEX-E---?EE-XXB-EE-EooEE--o--EXE----E-M-BB-f
m-ME-XE-oX-EB-MMB-XMEXEX-o--EXEE?-E-BXooXB--X--X-ooXX-XEMX-o---M-E---E-MMBEE-X-X---o--X----Eo-M-o--X-BEXXXB-X-M--EEEEX-o---M--BEEoMXEXXBB-E-BEBBXBEBE-BXBBX---M-ooXBoX--XMo--B-MX-X-o-XEEBBoX--EooX?E-oX
XE-E-EM-BX-o--XXX-E-EE-M--XEX?---X---?B-?XEEXoEBBEo-X-EXMBBXoEoE---XXXooEo-X-XEEoE---?XXEX--XXE?EMMBEX--EE--MBo?-BE-E--BEE-BXX--XE--?EB-Xo-B-X-ME--Eo-XoBoE-EEM--?oBEEXEXX-M--MXB-BEX?MM-?o--E-EMM-XXE-X
