-BMBBB-EMXoEEME-EE-E-E--BB-oBX-----E-XB-XooE-EX?-MXEX-EXEMEMXoXEB-XX-EXXX-EXMEX-M--MEX?E-XoEoEEXXXXE-EEB-MXMX-E---MX-XXEXEBoEoBoEo-XE--E-XXBEoM-XXXE-E-EoXoX-?-XXoM--o?Xo-XEoBEX--E-----XE--XE-?X--EEXM-
-o-E-EE---XX-oEXoXE-XX-EX----?-B?-E-B?-E--E?BEB-BX-E--X---EBXB-oEBo-EEBB-XB-XXEXXE-?EooEXBoMXoEXX--?ME--XE-BX-??XB-oMXX---E?--BXoE-X--B--X-EEX--E-oEE-XXMME?-B-EXoB?XBoBEM-o-o-XBo-BXXXX-E-B-MoBoXEXX---
-XB-BoBEE-BoEEE?-BE?XoXXEoMXEXXE-EBXE?oEE-EX?XMXoXE-BBo--MB---XE-XM--MX-BXEoX-EM-X?EEE?X??-X-XB-ooEE-M-E-XXoXXMB-?-EooEE---EMoXBE?--EX--XEM-oEE--o?EM?X?-oBBME--EE-?XEoB-XEXE--?EXE-XXE?XEXXXB---E-o-Eo-
-BEBEo-X-EX-E-o-?M-XXBBEXM?XoXEEX-EEEo--BX?BX--XXBoB?-EME-X--B---EoM-EoXE--oE--Boo-EE--XEXX?-BE-XooXEBEB--X-EE-E-XXX----XEXX--EEXMXo?EoEE-EEE-XE-XEEEooEX?BM-XXEBEBBEEM-MXB-E-X-XEX--E?-X??EX-oEEE--?XX-
--EE-X-B-XEEEEX-?BMXXB-M-BEE---oXE-Xo---EEXM--M--BB-EoBEBXBo-----B-E-EX-B--oBXX-ooE?oM-E-XB-XBooBE-XX?X-XBBXX?--EX--EE--Bo-?-X-BEB-X-oo--XXXo------EEMooEX--XX--BBoXXX----X-E--?MXEoXXX--BBXEX?--XE-XXE-
-BEB?o-M-oX--o---Xo-MXE-XMB-EoEXE--EX-EB?BX-XX-M-?BXXM?B-B-EXEoXB-BE-o-EEXX-EoEEB?X--ooE--B--?o-XoEE--BX-o?E-ooX-XX-MXo--XEEB--oX--EEBXXo-oXE-E?-?-o-EX-oBoXEEB-X-oEEX?EX-EBXEMEE----X-X-oX-oEoo--X-EEB-
---BE?-B-o-EMEBo-E?B-oE?BEX-EBEMBMBB--MXX??E-MM--XoMBE--?EX-M---?o-XoB-EEEE---?--EE?XBEXXX-oEX-XXE-XBXEXXoBoXoB-?--XEXoM?-X?B-EBoM--EXXXXX-Eo-XXBEX-EBX-X--BXEEXE-X?EoE-EE-BB-EMX--BEX-XXMXXEoEMEBX-EoX-
--EXX--M--E-o-XXE-XEoE-oX-Xo--X-oEBEMB-BEE-XXoE-EE-XoX?----B-X--X-MM-EEEMMXX-EE?EXB-E-EooE?-BBE----XX-E-BEB-o---o?o-XBo-XX-E?-E-MB--o--BEEXEo-Bo--XX-?E-E--XXXoEB-?XB?-?-EX-o?EB---E?XE-BX-?-?BEo---BB-v
-oEEXXXX-BX-XE-X?-BE-X---X--EB--XEXBX-?EoEEoM-E-oEM-E-EMX--XX??-E-XE?Mo-MBB-BX-XoBXE-BX----BM-o-XEMEBM-EE-XoXE-XMooo-B-M?-oE-X-o-BB-BXBBEXoE--oEo-o----oB-oo-XEX-X?-XXB-MX?MB-EEE-E--X-?--E-XE----Xo-XBf
-X-E-X?-EoMo-XEE---oEEooBBEME--XME---Eo-EE-XEE-B-XXXM-XEo-XX-?-X-BXEo--XX-BXEEBoMEB-X--XME--??E?-oBE-o--E-EEBEBB-MB?oMXo--?oEEE-EXXE-X---XXBBEMBEooXE--X-oB?o---oXE--XBo-oXo-?B-BoXo-XXB--X?-EBBEXo-XXEf
-o---EXXBE-X-X?XE-?----XoooXE?-oXEX--o-BX-BB-XXoE-XMBo---BXBXBXX-?-?---X?X-BoXoXXX-XEXM?oE-XEEX-EXB--XX--X?XXB-EBE-B?EEXBMEEEM?o?BXo-EBMXBEM-X--XE---XoEBo?EXEXE---EX--XE--BXoXXB-B-E--E----EXB---BXXoBf
-oEE-oB-XB-E-XXX-EEXo-XX-B-E--oo?BM---XEEo---XEMEE-B-Bo-XXoXEoE?-BE---EE--MM-EE--E-E-?X--EBB?-EX----XEBX--M-EBMBBXXMEEXMEXB-X-X-BX-BE--EXEooBXEB-----B-XBoX--X----MXBo-EooXEMM?EX?----XE?BEBE-EMX--BXXXf
--X?o--EXM?EoBE---BXBBB---X--XXXE-E-XXXE--B--BXEEXXXE---X?-B-----o-EX--B-XEEBXXMoXEXXX-?E-EEEooXXBB--EXB---??-EXXEE-XBEX--XX?-XoX--E-X-M---EoEM-?XBX?MEEXXEX-----o?EE-EX-BB-Eo-XEXXMEE-B--X---EXBE-o-XXf
-EoX-oB---XE-o-oE--oBXME?----BoBB-X-E-XX?XM-EXX---o-EBE--?E-E?-o-X-XE-EBX-EB-o----X??oE---XX--M---BBXXE---XX-oXEoMoEX-----B--oEXoBBEEoBMXBEoB--EEXEoX-o?o-o--XXXo--X-MX-XX-oXE--EX-X-EBo--oXM-EBX-XXXBXf
mXXMo-EB-XEM-EB----XMB?-EB-X-XE-XXo---EX-MX-Xo?-Eo-----XEBBBXBXEX?E-BoEo-E-XE-BXXEXB-M-XB-ooEo-E---XEEE?EXoEMo-Eo-ME-M--EEXXo--XoEEBXE?-BEXXEEXBXoEXXEE-oE----EB--BXX?X-B-E---EEE-oM--M-E-XEMXE-EEX?B?-X
X?EXEE?BB-oX-EE-XE?BX---BX-B-BX-?oBEoEEBME-BXB?EBB-BXXBEEoXE-BEXo-XXXMEEB-BMBX-o-E?--o--oEo-BXEoX-B-XEXEMMBXBBB-E--EB--M?EXEM?-EX?-BXXX-oEEXM-BXX-Xo-XEXEBXBo--B-X-X?E-EEX--EBM?X-oX-X-?-XEBXX-X?-X-BB-X
