--------------Bo-----oEB------X?---EE---o----?oB--B-E---E--XE-X?-B-o-X---oE-----E-?--BE-E-X--M----------B-?oo--BoE--X-M--------?o-E-E-X---?------E?M------M---E-?ME----B-X---E------M---E-M---oB--X--B--
-----X--E---MM-X---E-E----o--B-M-X--oo-X--M---M---E--?o------M--XX----------EEB--B-BXE---B--------M----ME--o------o-?---------MM-B--X-X----X--E-E-X----X--------?-X----B--Eo-XoBE---o-?ooo-o---------M--
-E?---M-----E--EE--?-MB-EMX--?B---X--MM-B?-?------M------o----------?---B--?---M-----B--B---------?--?-E-------XB-M---o-----E---B?BX--B---o-E---X----o-o-BBB-X-M----X-Mo?B----B-X-B--?--M--ME-MM-M--??--
-Xoo-o-?--o---M----------------?---o----------M----EB--X-------X-?----B---M------o--Bo-M------M----M--X----------oB-Eo-EE--?--B----E-----Mo-XX?B-E-M----M?-o------E----M-X--B--M----o---M----?------?-o-
--o------E--?---XE-----------M--BBoX----M----MBB---?---?X----X-----E--oME--E?--M--B----------X-EM-B--o--E-o-M-o----E---?-MB?----X----B-?-E-----B-o-o----------B---------------oEo----X----B---M--M------
--E--XE------MB-----?----E?-EB-B-----o---E-XX-o-----E--X--------------EE--E?-B---X-ME----?---oM---E----o--E-B?----EB-B-?------o-X--X------X--------X-----B--------M-oo-E-M-X----X---E-oBE---?----M---MB-
-X---o---M---------E-oXE----?M------B--BBX-?----Mo-B----------?--o---------o---o--?--------oM-------M-oE-----E-?-MEE--X----B-?o---------E----?--M-M-X--?-B----EX-?-X----M?----M-?o-X-----o?--?-?---M--o-
-------?o-----o---M-X-?-X-----X----------?--?-----------E--?---?XX-XM---X--B---X-------B-X-M-o-B-----------?-----MX-o-------BB-o-MX--------X--X---E------------XEBM--?-X----M----M--M------B--EEX-B----v
---M----E-B---?---BB?-?-------B---X-------M---B----?---E--X--X-E?--BE--?M---oM--------------M--------X------?-XE-----Bo--X--?---E-B-M---------XE--?-E-------E----B--M-------Xo------XX-------?-B---X-E-f
--?E--EXE-?XB----M-B----EM------M-M--XoEo-----?o?X----XMMB?----------M-X--?M------?--------E------MoM-X?-?E--MB-E-?-----------M---o-o-X---?-M-EE-?-o-o----Eo--------E--M--o??--X?--oE---o--XB---Mo-BX?-f
-o----M----o-B-----E-X--M---EEo---------M-?----------MB--M--M-o--?-----------oXX-----------------------X-------E--------B-o---X--o----B-----E---M-------M--o?---o--o?X-------E-X-X-M----EME---------X-Bf
-E----o---B--------X----?--X-E-----E-----B-X---o-?X--EX-?--o-------?---M---M--MoX-B---BX-o-?---M-------?---o----?-M-MX-----XBE---BE-E--E--M-BX--M-X--?----?--B-E--???o----------------------M?-------o-f
---E---B--?----X--X-------------E----o---oX--------B--------?---X----------E------B-M-E------X-M--BX----Bo-o?-?o-?--E---Eo---E-?--X--B----B--?----X-?-----M--X-----?o-o-X-o-B-M------?----X---?-E-MB-X-f
--BXX-o-B-o-----E--o--o-o-M-o------E?---oE--X--?---o---?---------M----?E-----?--o?-X-X-----oX--------M-ME----M----E-----E-E?-B-??---M-?-?B---XoE-M--------E-o-----?-o---------X--E---M-X-X------E-X----f
m--X-E-E-X------B-M--oBMM----M---M--X?--M----X-?----------?--BM------o---Bo--B--o--------E---M---?----EE--X-?M-------?--BXXX?-MX-ooX-----?---o--B----?-----------?-----?-E----------X--?-------E?------X
XXXEX?XXXXXXXXBXXXE?XXXXXX?MXXoXMXXX?MXXXXXXXXXXXEXXXXXXXXBoXXXXXXXXBXBXXXXXBXXoXXXXXXXX?XXEXEXXXXBoXooXBBMMXXXXXXXoBBXXXXXMXXXXXX?XoXXXXXXXXXXXXXXXX?XXXMXoXXXXXXXXoXXXXXXXXXBXXXXX?XXXX?XEXXXXXXXXXXXX
