-E-----?-------------E---Eo------o---?XM-----B-?M--B?---XB-EM-----oE-o---?--?o-o--o-?-?--E-----------Eo----?-----o-B----E------o--E------Mo---M---B------E-o-?---E-o--------o------X--M--?X---oo-oX-E---
--??o------?o-EBE----o-----o--M---X---X---BX--B-EE--B-B------M-E----X-MX-EMB---B---?------E-------?-?B-Bo--oXE------------?-----E-E-Eo-E---o---B----XX-----M---E-?-X-oX?-M--EM--o--?o----B----M--?------
--M-E----oME---------M-----E-------?------B------?-----BB----o---X----B------B-M--------X--EE-X?--B-Xo-------M-----o-oM---oMBX-B---X-B------------E---oE---B--o-?-BX--?------?-----XEE------?----o-o----
-----o--X-E----?E-MX?M---Xoo--M-oE--B-?E---o--o?----E-E-----B-BE-?-----o-M---X----X-oE-----B--?---EX?o-E-oE-----o--?--------E-B?-o----X-oo-----X-----M--?------MMM--MX--Xo--------M--------M?---ME?---E-
---E-B-----o--o-Mo----X---X------X----M--?B--------Eo-Mo----------X??-B-B------EM-----o---o-------EM---M----?-o---E--MM-E-----o--ooX-----?oXM----E--B--BX-B-EE-o----MM----------oM---XBEXBo-----X--M----
-B----o--BB---M-X----M-BB------o-E-ME------X---o?-------------B--B--EEEB-----M--------M---B--XB?----E-----?-E-E-----B--?XXM-Xo-oEo-oE-M----B-E-----X---------EEXX-----o---?--X--------oX-MXX--o------M--
---ooMBE-oM--M------X-M----E---?M----oX-XE--E---X---o-X--EM-E-X-B-?-------o-----BE------B---B----M-E?---B-----------??E-------------BM-E--------M--------------o-----o---X----E--M--B-----------B----B--
-o-?-M?-M---B----?------------------?----B-------B--o-B---XoMM-X-----o-----E--------X-X-----------B-?------X----?E----o---E?M-?---------MXB---o-------X?---o--E----Xo-BB----E---o-M---B----M----?-o----v
--------E-EMo---E--?M--E---MM--BMM----B-?--M?--X------o--?---B---ME------?--E-M-E-----------B---------E--X------o-M-?--BM----?-----X---EX--o------M---M----B-M-X------B--EE?--------M--?-X------ME-E---f
----M--o-MB--?o-----M------BB---oME---B----X-----M-BEMMB----M?------XB------X--------M-M-X----oE----o----X---oEE--X---E?M----------o---E--M--------X---B-----?E-oo------ME---X-----B-?----------o?M-M--f
---X--?-XB--------X-BX----Mo-E?--E--MX---E--B--?-----E----M-o-B-----------MB-------XM---B--BB-B?-----M---BB----o----X--o----X--B--?----?-E------o---X---?-----E-----------B--Boo?-----M--------B?Eo-M--f
--MM-B-----o-Mo-X-------XXE---?-?E---X--X---M-Bo----?-E-MBEE--o------M----oo-M---------BE-B---oE--B?-E-?---E-?--M---?-?---o-E------B---------?-o-----??--o-X-XBM---------?X----B--o---X--Xo-----B-----?f
---M--BB--B?-?----E--M-M-X--o--o-----?B------X-----?-?-o--B-MM---o---o-X-XE-X-B--B----E?-X??--M--oM-MM---?--X---E-----E--B--B---MM----M-B--o?----E--------oE--BMM-----E----E--X--M---oX--E?--MX-?-M-o-Ef
--EXE?-------M---Bo----------X----o-----E--o?-?--?-M-B---X-------X?-------------?-X----M-M--E--------------EMB-o-E---o--?-BM--E-X-oE--?------B-------B----X---E----?-M---E-o?--MMoM-o------M-?MEB------f
m------------B-----E--E-------B-----------T-E---oME---BXMM--X-?-?-?-B-------M-Xo?----------MT-------B---?M--?--M?---T?-BMB---X----T-E-o--?T---M--Bo-?-----BX---------T----T--------Bo--Mo--E---X---o-X-X
XXXXEX?XXXXXX?XXXXXXoXXXXXXEXXo?X?ooXX?XXX|XXEoXXXXXXXXEXXoXXXXXXXXMXXXXEXX?XXXXXXMXX??XEXM?|XXXoXXXMXXXXXBXoXXXXXXX|XXXXXXXBXXMoB|o?Xo?XE|EXXXXEXEXXBXXXBXXXEXXXXXXX|XXXX|XXMB??XXoXXXXXXXooXXXBoXXXMXX
