-o------E-B-X--E-M-BE----EM-----M-BXB-B-----o--Mo-----o-----o--E--M--X-----------E----?---B--BX--B--M-?o-------Mo--------------o----E--Bo-------B-----oB---?-EE-?--------XMX--?-?-EX-----BM------BB?E---
--oE-M---BB--B-------o-?MoX---------B-E--o------E---BM-----M-ME--o----M--E-MX-M?M--B-o--Eo--oX---o-EE--XoX-o-X---E-E--BB?B-----?------?o-o-o-----X--M--B--o--------------------Eo----oE-B---o?o-----M-E-
-?M--X-------MB-XMo----?----E--o--o-?Mo------E-B--oEXo-B-M---oM----------?------------M?--E---------MXX----?----------XE----E?-EM---Xo-X--------E------o------M-------?o-?E-----X----EEoXo-------?M--?M-
---o--?--M--B-------?----------EB---XE-?----XB--B-E-B---M---E-X---E------?X-----XB--E-M?--E----BM-o-BE----M----?BMo-o-o--M--?--M--oo-B------MB-M--?--B------B----X-----oM--M---M----Eo--E?X-MX---Mo--M--
-?------?---o-XMX------o--Bo-?-----o--o-B-------X?------EX--M-EM-------------X--o--M-E--X-M-M-E--oE--------?-------?-o--X-----BX-?----X--------M?BB--??-?----E-E-B--o-E---X------o-X-Bo--?-------B---E--
--M?-E--M--B?B-oX-X----X?-o?-?M------B--------E-------------?---------?-E-o--ME-----Eoo---X---oB---X--X----M-o---M---E--?oBE-B--B--B-----B--E-M--X-B----M---?o---X?Mo--------X--B-?X--XE--?o---?-?BM----
--M---B-----XEE?--B-?---??----oX-X---B-Xo--o-M--M----XoMM?--X-E-B---M----?-B-o-X--------MX?-B--M-M-MXM-----o--??-?-M-M--?------XB--X----X-?-E-----Bo--------M-MBM--X-------?--BX-?Xo--X-----XE--XoX---B-
----XM------o---oo--o-----M-E--------BM---o-?--EB-?o----X-M-EXo---B-EE--oEo----?-----o--oE----XBEE------------M??-----?------?-------------M--X-----------M-ME?MB--E----?---------E-------X-M----------v
---B--XB-?--------M-M-M------------o----MBo--M------X-o---------E-X-X-BB-oE--------o----E?-------M------------------BE--o-----X--??--X----------X-B--X----X--E-XX-E-----o--?--B-------MM---------------f
---E-E----M?----M-o--B------M------E?--E----MX?X-o---Eo----B-o-E--------B-E-o--?B-?-XB-M---M---M--------??-M---B----B--X-----M-----MX---B-B??oEM-------B--X--X---X-EX-----X----M-XMo---M??MX----?M--?--f
-E-----M---o--o-o----X----E-Bo----oB------oB--o-?--EM-E?--X-----X--E?---B-o-o-E----B--?o-----E--X----B---oB-----X-----EE-?----EX-Mo-o---E-X-----M----EB-X------E-?-?----E-----------------X---E--B-----f
-o--M-------EoM-B?---o-?-E-B-M-o------X---E-M?ooEE-------B---------------X?----?---------B--B-M-oo--M----B---?--X--X----E----------o?---------B-o--------------EB---B-BE-EE------E-M-----o--oE-----?--Bf
--M-EMB----M--EX--E--o-------M---M-M--B-X-X--MM----X--o-E-----EEEB---XoX-----BX-B-Mo-----------------M---o----E?B--??---X-X--B-o-M--E-B---?--MX------B----o?-M-------E----X------?MB-X-?B--MX-EM--B--M-f
-?---B-EME?--B--X----X?-o--o-------E-----o-X--EB-----??----B----E-----------E--?---------M-B?-EB-----?-B-M-----B---B?-XB---o-----o--o-XM-X-------o-?--E--M----------ME------B------XoB?-----------?--M?f
mo--B-------BM--oB---B------M--o---ME-BM-E----X--MBoM-M--?M?------M--XE-XX-E------BM----o----M------X----B----B---------EM?E--MM---M-B?MB?--M?---B-?---MX-?X-B---E-----M--?oB--M--------o-oE-M-----oX-EX
XXXXXXXXBEXX?XXoEXEXXXXXXXX?XXXXXXXXXMXBXXXXBXXXXXXoXMXMXXXXMXXXXoXXoBXXXXEXBMXXXXEEXXXXXXXXXXoXXE?XXX?BXXBXXXXXXXXXEEXXXBXEEXXXXXBXXXX?BXXXBXXXBXXXXXXXXXXMoXXXXXXXXXXXXXXXEXXXXXXX?XoXBXXMXXXMXXEXEXXX
