---B?M---?-B---o-Eo-BM-X--B--B?-E------E-M---BX--oMB---B--?-EX---B----B-??-BX-?---X----oo?-E------o---E?XM---M--EX--?--E-E-E---B?-X---E-E--------M-EEM?-X---B----oE-X-------o--o-------?--o-?-X-oo?-----
-------------Xo-?-MBEB--B----X---XE--X----XEM--M---------------X-o-X-------ooX-o-E-?MM--E-------XXE?------?M?-----BX----E?o--?XX----E----M---------M-E?--X----BX--XE--BX------ME-o--------X-EEMB-X---E--
-M?o-E--XX--?--o--X-B---?-o---B-------M---?-o----X-oM-oM----------B-E-----E----o----XB--------------------E--B---X--?E---------X-B-E---M---E--------??-MM-?------M--------M--oB------?----M--o------M---
--B----E-----E----o--?---XE---------X---o--oM?-X--E---?----o-BB----B-EXM-----M-?--E---X---?--M--?X--B-----X--o------M-E----?------?-EB-B------X---E---M---------oE--X?-E-EE--?----?---X?----B-?---o-----
---------MM-MX--Bo---?E--B-o---B--B----------M--B-X?---o--?EM-o-?-M----------X-B-----E----?----?-----XE-B----?--M---o--E---B---B-----o-----?------?E?-o-EE---?-----?-----E-BE-EX----E?--o-------X----o--
-------B?-----------E-o-B--------?--Mo----E-M--------E--Xo-X----------X----?EE-XE-----X----------o---E-?---B?--------o-B----------B-B--Mo-----o---------B-o?---M--?---o-E-----??-----B-o--o--o--B---o---
-?--------E--X--M---------E-oX--------B-----?E-?-----?----BoX---Mo-MM---E------B-o--------?--oB-E--M-ME?B--------?---M------M---M-B--X--BX?--E----o----------E--B-M----M--Xo----BoBoX---XMoX-----ME-----
-E--------------B-?X-------XM----o-EM--------?MB-?-------?---oE---------B---E---M--o-----?---EM-?-M-X-B--E-X--XM----------M---X-?o----Mo?-------o?--?-B-X-E-----B-B-M--------Mo-----------B--o----?--E-v
--------MB?o-o----------B-------E-------?-o-M-------XB---B--BMXo----BX-----B-----M--BEoX-o------X--E--X---B-oBMM--M----M-B-----o--B-----E---B----E-------MB-o-X-o---o--M---B------o-M-B----o-B----E-?--f
----------B--?----??--X---Bo--M----E-?---M------XXM---E--M-o-M------------o----Xo-----------M---?-E----B--B------------o--o-BE------MMX---------B-------o-------------?EoM--o--M----X----Eo-B-----oX--Ef
-M-?X--X-E-o-------?--B--X-?M-o----M-M-M---?--BX-X-o--------EE-----------E---E-BX--M---?-E-------E-E-EX-----Bo-------o---X------M-B-X-E-----o-------B--?---EEE-----E-?-X??-E--BX--o----------o--X------f
-o---o-?M?--E--MEo--B----X--M-M-?B--X--E-o-B--M---?-?--E--E--------o--oE--M--B-M?---E-----?BE-----M--X-?-X---Bo-----M-o-------E-Mo--E-M-B-------------?--MXX--EE--X-B----M---BMBB-B--B-X---o-o---B--E--f
----X---E------M-E--MM-?----X-------E----EEoo-E---?---------M?--?--X--B-?-E--XX--?-M--o--M?-B-X--E-MXXE----E--?M-B--------oX--E---ME-M---?-ME---E-M-EXM-?--o-B---M-----MXX--B?--?EM--Mo?-----------?---f
---o---?-----E-??-?-M-E---MX-----o-----B-----MoE-o----o-M----Xo-X?--B------BE--X-E-----BE----M-X-MX--o--EB-----E------?--B------o----------B----B-XE--B--E--oM----------X?---B---?B------o-X--M-X-E-o--f
m-M------?--------------B--o--M-M--XE--ET------o-To-Bo--o--E-BXX---?o--T-------o-T-?-------T------M---TE--B-B-X?--X?-E-T--B-T-XBM---?-------B-----?---M-T----??-MEXB--o--M--T--E-T-M-o---X--oMT--M-XE--X
XEBXXXXXXXB?XXXXXXXXXXXXXX?XXXoXXXM?X?XX|XooEXMoX|X?oXXXXXXXXXXX?XXXXXX|EXXXMEXXM|BXEXXXXXM|XXXXXXXXXB|XXXXXEXXXMXXXMXX|XXXX|Xo?XXXXBXXXMXXXXXXBXXXXMXoX|XXXo?XXXXXXMXXXXXXX|X?XX|oMXXXXXXXEXX|XEXXXXXXX
