-B--o-o--?---o----BB?----E---o--E----?-B---o--MB-M--ME-?E---E?EME-E-??---?--?---------XE?---X-?o--?-B---M---B---Bo--B------M?X--E?---E-------M-----E-X--MB--EEXo-?EEE-M----B-?-------B--?-----o---------
-M?--o-------E--B---?E---?B----o-B--?--Eo--?M-----o--oBB-o---E?--X--B-----MME-X------------X-----------EM-----ME--X-B--B--M------o-?-o--X?-B---EE-E-o-?---o----B-Eo---BM--o-------MX---X--?-M----X?--oM-
---?--?---?--------oE-?---X-M----B--X-------XX--MMoBX---X-B------X---X?---X----o---M--B---XXo-M----E--E-XXXX--X-?---------BX-BB------?E---E----------------?---o--Eo-M------?--?---??----M-----X-E----E-
--ME---o----MM-MM--B----X---X?o-o---------E----??-E----BEo-Xo-o----?--------B---M--o--X--B-------BoE-Mo--------------X-----M---X--o---X----oEM?o-o-----MB-?--------------M-E----E-M----------?------o-M-
-----M-o-------?--M-E--X------MME-E-X-----E-o--?-----o-------Bo-------E----?-MM-X-?X-E---B-----?-?-B---B--X?----?--?--E--XBME-?------E--MX-X--------?B-Mo-BX---X-----------o?-------M----X---M-o--------
--------M--o-X--?-X------B-EE----XE---M-----B---E-X------M--oE-o--M------?-oBM-------o-E----?---B-E--B-----?--EX----BME?-BoBE-------XB--X---X?EB---X-?--M-------?-B------o---M-o-MX---X--XX-X-X---o-X---
----oX-??--XX---------o----E--oB-----E---E-E----E?----BE-o-M-B------?------ME--------?-?---------o-------------------o?o--M------XE---?EBM---?----X-M-o-M--M-------------------B-M-o--?ME-E--E-----B----
-----o-------------E--Bo------M------M-?XEXE----X----MBB-X-E-MX-?-X-B-o-E-?----BoEE--?-M----B?--M---B-E-M---?X-E--X-E---o---------E---------------EE------E----E-M---X----?B-X---------??--ME--E-------v
--B-E-E-------?Bo-o--M--o-X----oo-M---------?-o---o-o-X-----Xo---B-----oBo-?-o-E----?-M---Eo--B?-MEE--X--MX----------MB---XX----B-E----B-------?-B----------------B---X??--?----E-E-?-X-E----?-?-M-----f
--MX----B----o-M---X-o-o--?o--E-M--M--EXEE---?---E-E-----X-E-----oB--o-?----B--E-X------X?------E?--E?-XM--o-------X--X----X---EXM-E-----o----------o--------XX?E--EB--B?-----------B?----o?-----B-?-BBf
-o---X--X---BMB----M--?o--M?----M-X-----E----------o-X----------------Mo-o----M---E-------------o--B------o--?-E----?-----------E---------E-------------E--E---?-----M-----?-?-----E-M?-oX-?------o----f
----X-X------X-?-----B-?-------------o--EB----?-BX--?---------o--------B---X-M-E--E-----M---?------o---o--B?--?E-E-M-------oEB-----B-?XM-XX-X-------?-----MB--?---B---------M-E--?oB-E-------------MX--f
----E----------X------E----E-----M--EME-------?--------XBMX----EM?o---------o--E--o?--E--BX-----MX--B-------XX--M-----ME-M----E-M-?---o----?---X-----M--------------B-MB-BB----X--E--?--E-E?------B----f
----EX--B---B--EBB---?E----oX--Bo??B--XX-ooM?--------E----o-------o--o--B---M---M-X----Mo---X----o----E--M----------------?---o-EXXM-X-M--B--XXo--B-MMo---M-XXB------XM-------?-?--E--o----?o------o---f
mX---X-TM--T-o---B--X-MX------TE-E-M---o-B?T-----X---X-?--T-----MB---E----?--oB--B--B-E-?-BT-T-------B--M-------XEo-?-M-----T--------o---B-----T?X?--?E--B---o-M--E-?ME??-B--EMT----------XT-E-T?-M--?TX
XXB?XXX|XXE|EXXXMXMMXXXMBX?XXX|XXXXoXXMXXXX|XXEMXX?XXXXXXo|XX?XXXMXXMXXXXEXXXoXXXXEXMXXXXXX|X|XMXXXXE?XBMXXMXXXXXXMoXMXXXXXX|XXXXX?MXXBXXXoX?EX|XMXXXBXXXXBXXXoXXXXXXX?XXXMXXXX|XEXXXXMEMXX|XXX|oXMXXB|X
