---E---XB-M---o-??-o-?BX----?E---E------ME--?------?X------M------------E-E-?---M?---X----o-o---o-EE--X-------M--M---o---B--E---E--E---M?B-MMM----------X--M--E-E--------M--MoXE-X-E--EX-E----?B-o-Xo---
-o--??---------oBX---------------Bo--------E-X-o---E----X--B---B-------M---?-E---oXX?-----------------B------X---------X---o--?-B-BM-M-B-M-B---M?-M-----o----BE?-M?-?E--B-M------?---B--------ME---?-MM-
-o------o--B-M---o----o-------------M---o?M---E---E-E---BMMB----M------Bo--oX--o--?--E-X--B--B--B------o--------M-XMMMM--E-----Mo---------?-----M--M--?--------EM----X-?--oM----X?-MX--o----------E---E-
-o--E-o------------X----M-----BE-o?------EM---oEEE---BB--?--o--E--X-M--o-?-M-X-B----?----Bo--------Mo----BXB-Boo--o--Mo---o--?---XE--?XE-Bo--M---------M-MB---X-------X---o-o---E---M-?--oX-----X-?-?---
--?o-?B----M----X---?----?-------------?---??-M--B-o--MX--B?E----o-----o-----o--X---o----Xo--BB--------?-----o-B-o-XM--M--------?M--Eo----M----o-B--M-E?---?X?--??oX-X--EM----M-----------E--X--E--o-X--
-o--XM----o-----E-M-?------o---M---E--X------?-MM-B--X-------M-M---oo--M--MM---E--X--E--o?------------?X------X--M----o-B-?-oEo-X--M---oB--o------E---------B-?-o----M-?------B--?B---BEo---MB---E----?-
-BM--?--MXoB?-?---Eo--o---------------BBo-B?------E?E--o-MBM------X-----B-?-??-B-----EX-------M-----??--M--------?--------EB-B-X--M----B-E---E----E----B-----B--------?-B--X?-M---B-M-o?--------E-------
-X?-X-B-?-M?ME----EX-E??-EM--B------BX-----o---?---E-----------E-?-BM?-------------EE--------------------EE-M-M--------------Eo---XB----M--XM--o--Eo-B----EXo--??---M-Mo---E?--?E---MX?-M---B----B----Bv
---?---?-X--M-E--------?-------?--?------B?oo---BM-XX--X?----X-----E?-o----?-oBoo---E----MXE??---B----B?-?-o--o---EE-----M---?---BXB--E---E--M--EB--------?--B--oM---?--oMX-M------X--EM-------E-M--E--f
---------E------M--M-X-B--E-----o-------oM-X-XMo--Xo------X-----M----------??--MMo------B-o--M--o---E--B-B--M--B-----M-E----?-----X---oMB-?-------EM--B-XEB--------X-?------B---oE-E----?--BMMEEE----MEf
--M--E-X?-X-----B-M-----------X----M------Eo-?----EB--M-M-----XM------B--?X----Bo--o-?Mo?-----o-?-B-B------?-MXXB?-------o?o-EE------?X---o-M-B---o---E-----X---?oM------B--E-E---?--X---EX-----B--X---f
-o-E-------------o---M----X-o--Bo-------X--X------oX-------Xo----?X--X--o---o--?---M---oXE-E---M---M--X---o---B-E-----B---E??MEMB----E-ME?-E--?--------?-BoBM---------B-E-E---ME--?B---E-----X-XM-E----f
---o-------X------M----o-MM-----XE-ME--?----oB---?---o-----M--M-----------?--X---MX----EEX---------X-----X--M--X---M----Xo--?--M--X-----?E---o------BX-M-X-MM-Bo--?B----?--M---?--X-----?-M---------B-Bf
--o-B-----M-B--EM----M?-----E--o------------?--?---M--X-BE--------------X-?-?--?M--B----X-o-----oM--o---?-E?M---M-M--M--B-BXoo-EX--M-B?-----B-----o-EBX-----o--X---M-----E-?-M-BE-X---X--E----X-----M--f
m-E-EB-T----Eo----o------o---?---o---X--B-BX---T-M----------B?T-T---ME----------B---o??-----?X-BEo----o----B----B-----M----M--X-EX-T-M---T---o-?--M-----------------E------X----o-----Bo--BME-o-T-??---X
XXXXXXX|XXXXMXXXXoXXXMEoXXXEBXoXXXXXEXXX?oXXXXX|?XXMBooXXXXX?X|B|XEM?XXMoXXXXoXXXXXXXoXXXXXXXXXXXXXXXXXBXXXXXBXXXXXXXMXXXXXXXXXEXMB|XXXXX|MXXXXXBXXXXXXXBEXXXXXEBXXXXXE?XXXXXXXXXXXXX?XXXMXXXXXX|XXXXXXX
