--ME---X--B-------o----Xo?-Xo-XoE---X-?MXME----X-X---E---?-EBX---o----XE-EBE?--?-----------o-X---?---o--X---XE-X----o----E--X-X-o--XX-Xo--o---B-o-X--XXXX-M-----X-M----B----M--X?--M?---X--X-XB-M-------
-X?EX-B-B---B--XXB------X--o---M---?X-----E------M----M--B-XM-E-----B----XE---X------o-------X---?--X-----MB------X-oE-EX----B--E------o--X-X----o--------?---?XE---M---o?-?--B----Eo-X-B--B--oB--E--M?-
------M----Bo--o?------M-X--X-XX--M---XB-X---------?o--------?-BX-B------M-------?--X-XX--E----B--Eo---E-----X---B-?--B------o-XB-M----BM-------oo--XX----?--------oX-o--o?B-?-?-o-M---?--B-M-XB--X?----
-X-ME---o------X-Eo??X----M-X---M--M--------X-------M-BE--?o--?oM---?EX-EE---X----?----E-?---XX---?---------X-XBM----o---?--M?EB----E-----EM-E-XooM?XX-?M----MoX-----X---B--X?EX----oMo--X-M--X-?X---XX-
--X-E---E--------X-XB--o-----MX------MX-B-o---o--XX----E--E----B---B--BX----?o-E--BEM------------B---?--XBXM----------E?o---E-------XX?--E--oX-BoE----------?-EXE---M-?-X------------E-?-??oX--X----?EB-
------------B--B--------M-------------B--o---o-BE-?X?X-BB?EEo--X---BX-----o-M-----MM-----------B-o---oM-----BE--------?EEE--X----------X--o----X-----EM-X----?-M--B?-------EM-M----oX-----X?----X-M-oX--
------?----E?XX----X-X--o-EM-MEE-------B--?E--o?-Bo-o-XX-----?--X--MM-B--E-------------oMX?----?-X-----------oB-X---o------------B---MME---X-X-X--E-X-X----M---M-o---?M---o----o--X----X-?X--o-BX-------
----BooXo-M-BB---MM--------?M-----------X----------B--X---X?o--E-XMo---o-?-EXEB--E--------BX----oXo--o---M--E--oX-X?-X-B----E----M---M?-X------o---o--------E-E----XE-?-?-B-------?-EE-?-X------M-----Mv
-?--oE-X-------o-M-BEX-B-----X-E-------?oM--------XB--M--X-X-X--------?--XBX-----o-EX-----MMoEo----?------X--XEX-??E--EM--XXE?-XX--M----B--M--B-o----XB------?EEB--o----BMBXE-----X----E---XEXXBE---X--f
--B-M---B-EXXB----?X-??-B-X----M---B-------?--?-------XoX------oXX--EoE-----M---E-----M---X--M-?-o--?-X--XEB-----X------?-BX-B-XX--E--XoM----E--M--M?-----?--oE?-M-X--M---B?-?---MB-?o----oX--o-X--M?-Bf
-B--XBX-M-----------B-X--o---M-X?----M-BX-B-oE--?M---B-BMBX-----M?---oM-----?B-X?---o------MB-----M-E----X-XX----E---X--Eo-X-----------------BXMBB?----?-EX----B?X--XBXE---------------o--B--E?--X-o---f
-Xo--M------M-------o---M-X-------o---?E---??B---E---o-M-X?--X-M--ME--E--X------XB-XBX------X--X-B--E-------?-----E-----X-ME---E---XE--E-o-XM-E-------B--?--o--M-X--X?--B-o-o-X---------B-E-ooM----B-XEf
--E--o----?-M--?--M-X---EooX-B-B--o?-??E--XM--EMX-------BX----?B--X------oBM-Eo------X--M--B-?o---X----o-XB-Mo-XXX---X-M?M--E---B-----XEXB----X-X--?X----X-EB--?X-?BME-EX---oM--B---?B?-E?-X----X------f
--M?-E-------X?E-o-B--MXo?X-XX-X?X-----------E----o--XE-------E-?---M-----?--oX-o-----B-----B---?--BXE--Xo--?B-X?-B-o---X--BBM---oB-XM----M-Xo-M--E-o----------XM---B??--MM--o---X--------X---------X--f
m--MX-----B--o-XXo-oB-------E-?------?-E------MX-E-?oX----B----?E??EXBX-------XM-X?E---M--XM---X---o-M-----M-----X--o----EM------X-----X--B----o---------E--B---oX--o---------B-----X---?o-B---?M------X
XoBo-o--X-B--?-----------------E-X---?---oM-M--o---M-M-X---X--X-?EoX--EXBBB--B-BM-MoE---MB-o----X---M--MM-X--X-B---E-?---?M---X------E-?-X---X-XM-X---Xo-----o----E----XXX?------Xo----B-E---M--MX-X-X-X
