-XM?-----XX-------------B------------?-M--?-B----B------Mo-o?-XX-E--Mo-o--E-o----Xo-X-oEM--------X-BX?XX-E---------XM--BoX---?B-X---------XE-BBE---X--------X?B?-------MEX---oM-----B-------X----B---o--
------B-X-oM-o------------X-o--EB----XM-------X-X--?-------?o--o-----M------B-------XE-----B--BM-M-M--X-X?B--------?--?-X----X--E-B-----o-E-?M----?-X?E--MX?-------E--------MB---o----oX-?B-M---M-----o-
-?-X-------XX-----?-X---X------o-?o--M-o--X---B-B-?-Xo----M-------M-----M--?-X----X---o-E-?--------XE-------M--M----XBBME--BXX---Xo--B?--X-B---X?oX------XX-X--M----X-?-oE--------BB-----BM--XM---?E--o-
--M---E--B--------M---o----E--X--E-M--B--M-X-MEEB--B-M--o-X--o--XE?-----?-E--EX?-o---M----BX-X---X-?B--XX--X------M-X----E--X-B?--XB---MX----X?E-X-X--X-X---?----oMX-M---EoE-E----?B-E-EX-?E--oBBBM--E--
--oXM--B----??----?----E-o----BBBB--?----?o-M--o--?-?----o-M---B----o----E---X--X---B---o--M-oMX-?-B------M--M--X-XX-XM-?-XM-o---B----?--------E-BBX-o-----M--oo--X-oBX----E--MB-------XX?o--?---?-oo-B-
---BXX---E--?XM--M--BEX-o-B-X----o--X--X---XXo---BB----B--o------X--B-BM-EE------M---ooo--XBX---E-B---------EE-o-MXBB--o--?XM--XX?----o---XM--EX----o--oXB---X----X---------E-B-E---X------oM-----------
---X-XE--E--o--B--oX--X-M-X-?-X---?-----B--?M-E------B---?X-M-------XX--MB--X---oB----M-M---oM-X-MX----MM-B-----E---o?o-B--X-M-??--ooB--XX----E---X--XE-B----M-M-ME----MooB-o-Eo----B-?-Xo?o----M-------
--M-EB-BXMX--X-E-----X---------X----MM--XXoMX-o--o--B-E----X-E--BX----XBo---XoB-B--BX-------?XX?-----Eo----o--?---E-MB-----XMM-----------?--o----B----E-X--EE-----o-o-o--E--o--?B------oX----XX-------Mv
--XM-BoB--E-X-XMXX-E-E--XB-X--X-M---EX----------X----o-B----M----XoB--o--B------o--X-----B-X?M---X-X-X-oB------M----o-E---M--M-BB-EX-----X-o-BE--X--X-?M----MXX-?--E-------M---BXB--E--o---M-o--X--B-oof
---Eo-M-?-E--M---M--E-o--MX-X----X-o?B-?-M---------?X-MX---X----BX-X--X-X?M-XB-X-XX-X---B-oMBM-o--o?oE----Xo---o--X---X----?--X--X-------B?-E------B-E-o-----oX---X-B-o---ME---M--X------M--M-BXE------f
--X-o--M-EMX----------X---?B--o---X-------X-oB-?---Xo-----BE-o-M-E---------E--B---B---o-----?--EoX-?o-----o-EXB--?--??M------MXB---X-M-----oB?---MB------o-B-EM-o--X------B?-----E---?B-------M---XBEX-f
-?o--oo--?---------o--?------oBM?----M----EB-Eo-XM?-----B----E------E-B--MXX------o----?--X?----X?X--?--X-ME---o-M-X-o------XM---X---M?X------E-ME-XE-B-MEo-E--M?X------M----------X-XME----E?-oB---o--f
-BX-B-----B-XM--Eo-------------------B---o-?X-?--B---X------?------?-------XX----X---M?-----MM-------Xo?----MMMBM-E--X-M-M-Mo--oB---XMXX----o----M--------M--XB--o-B---M-E-?-?-X----M--E-------------?-f
---X------o-B--X----E----oX------E----o-MB--o-X-EXE-X?----X-B-----BE----o-MX---Eo?--M--M--?XB--X-------EX--o------B--X-o---E----X--?-XB-EEX--E--EM-?-X-o--X------BM---X-o----E----oE-B-E-------M-oBo-oXf
m------o-MB-----------B-Xo---?---B-X--B-X----B-M-BXo----?---o?X-EX-X---------E--o?B--?--?oX--?o-MEX?-o-B---B?--oE-o-M-B--EM--------BB-------XoM-ME-oM----?--?E--------X-?BX-----EX---M-E--------X---o-XX
X--o--X--------X-EE--?-Xo--------E-XBX---------EB---BX--Moo------o-?o-B--XMEX---M-M--XXXE--o----MBB---?-------B----oo?E------o---B?XX-XM----oE--XE--o?------B-----------X------X----o-?------M-?--EBM--X
