-----------------X?--X-------E----------------B---X--E-M-----XB-o--X---M----MM------X-?----E---E-B--M-E-MX-X--oM--o--X-M------?-----M---E----------E----?--B----X---B-?--------B-M------XB-----E-?M-----
-?Mo-B---------------------E?------BE---o-oM-oMX-BoB---?----?--X------B---M-?-Eo-----o--B?--M--B-?-B--------M------E-X---M--MX------B----BE-o-------B?--B------------X-M-?-?---M--E--XEo------------E---
-B----B--?-----o----?-o---o-?-oX?-----?--M-Eo-----XE?-----E-------E-B-------M------X--X?M?EE-----BB-?-E--X-B--E--M--o---EX-----E-E--------o-------?--Boo-----M------?-----B-----E---?---o---M-----o-----
--X--M-E---E---B-------B--------BM-----E---o-E---o-------B-BE--?Xo----X----------B-X----E---?M--BM----E-----BX--?EBo------E-----M?-B----?EX---Mo-oM--E--E-MX---Xoo--M-o-----------E--X------B---o----XB-
-----E-E---oo-M---X----M?o--MB--X-----XM---X----o----X----------------o?--o?----M------oE-EoX---E-E-EoMB---X--B-oB-EE----BB-X------oB-E-o-o-----X-----------------X-Mo-?-?-B-o-BE--oEXo-------BB---E----
-MX---B--E-?---E---M--?B-E-B--X---o??---E-----------?XB-----X-B-X--X-o-------------E-?--??X--MX-----------?---?B--o----B-----o--E---o?---XB?------o-MB--E--?M--X-EEM--M---B----------Xoo---------M------
-X-M-------o----------XX------M---oX-------B-E-o---EEo--?-------------------B----X-----------X---B-M----M-BBB-o-EM-M---XoE--E----E-oX-o---?ME----BE--B-------M-ooo----B-----M-M-B------?Eo--?--E---M----
---E---E-------?---B--M--o------M--Bo---MoX--------E-----E?B--------------X-E-?--E---M-X--B--oEo-----X-X?------o---BXXM------XoMBX--EB---oEo--MBX-XB-E--oB-----EM---M-oE--X-E--XB----XB--M-EB-?-E-----Mv
---MBB----M-X------M---X--XM----B-EE--M---oo--------o-------------o-------B-?---------E-M-B-M---E----B---o------MB--X-oE--------X-M-B----o-?o-?----Eo?------o-o---B--M--o----B-M??-o------o-MM-XM------f
---BE--?------E-o-MEBX----?--o-o-E--------XB---X-------?--?---oM-----------------?--------M--------M--M--??--MM---?oM-?--oE--X---B--B-E-?---------B--E-----M------E----X-?-MB---------EX-o-?-o----E----f
-o-B-E--o--E------o------E-X--------X---??Moo-o-------------------B?-------B---XM-------Mo----?---o--o?---BM-XX---ME-o-o----X---o--?o---------?BXXB-X------?-ME-M------?M---M-?--B-----MM--B---X-EBE---f
----?-----BM?----Bo--------XBM----B---??X?X-?-?--------?M----Mo-----o-B?------?----------ooMMX-----X---?---?------M--o---M--------M--------------X--X----XEo-M-EB-M-B-M--M-Mo-B---ME-B--?Bo-------M----f
---M-----X--EBE--------X------------?----E---o?X---E--E---M-EBE---oM----XXo--B---------X-M-oo-B---M------X-----o-oo-?------------BM--------B--MX----BM---o--XM-o------M-MM----E--------X--------?--BX--f
--?------B-------------------Bo----?B-o-XX-E-X--B--oo----X-----M--o---EB-B-------B-EX--X---oE?-X----oB--X?--X------B-X--------B--?---?--X-o-----B--?----?---M?E---BXB---E-------X--M-----XXE-----ooX-B-f
m--X-M-B----Booo-----?-?--M-oo--o-X--E----?--X--?B---------?M----B----X------------MM----?-------?B----------B-----E-M--M--B-oo-----o--M-B?-M---X------------X---E---M-Xo-o----o-M---B-o--E---?M-B-MM--X
XXXXXXBXXXXXXXXXXXXXXXXoXXoXXXoXXXXXXXXBEXXMXXXXEXBXXoXEXEXXoXXMXXBXXXXBXXXXoXXEXoXXXoXXXXXB?XXXXXXXXBEXXXXXMXEBXXXXoXXXMXXXXX?oo?XXXXXoXEXoXXXXXMoXXEXBXXBXXXXXXXXBBXXXXXXXXEXXo?MoXXEXMEXXXXMMXBXBBXoX
