?-------ME--o----------M-----B--B----o---M---o-X-----M-----o---X-EB--M-------M?---X----?XBM----MoEX-------?----BX?-----X?---M---o-----E?--o-B?o-o-------oM-M-----B------------X--Eo--BXX-E--------oX---M
E-X--B----B-------------o---XX---?----B------B?---B----??-B--?-E--B-----B-o??M-MEE----o------o?Eoo-------------E----o--M----?--BX----MM---B------BE--------M---EEE-----E------oo-oB---M-o--E--------Xo-T
E--B-?--M-?-?----------E-EB-?o-----E--------BX--------E---o-X?-------B--------------M--?X-X------------o-B------------o----Eoo--E-M--MEB----oo-M------------?---o---oX-MEM-----X--M-X-----------?o?----?
M-----------E-M--o---?Mo---o-------B-o----E-?-?MB--B-?---------M--Xo---?MM-Xo------o-o---o-B?---------?------------??-E-EX----?-----B-E-----XE------?-?o?M-M--o--------XB--EBE?---X---Moo--o-----M-----M
TB--E--MM-o----?---o-o------XM-----B---?-?--------o-----X-B----E------o------MM-B--?--E--?-B---------o--X--MM-----X----E---oM---?---E---M---B----M-----X-E------------o---?--------o----?--B-X?-B-E?---B
|?-----o--BX--------?----B-------?M-----XB?-------X??M------------M-E-E----M-Eo----ooM-----M---EB---X----B---M--X---M-----o-----?---E?---B-XEo---E?---o---?---------BB-oX-?E----------EE---X------o-XX-|
E--------X---XEoB---o?-oX-M--?-E--o-MM-----------Boo--M--M--o-B---o---M---ME----o--o-E--oMM-E-----X--X-??-??-M-----?------BB---?--------X----BXE---------oMM---EX-XEM--?-----?----X?-----M---X-------B-B
EBo-E--M-o-EE---------B?-oB?----B--?---?--M--------o---B-X----------?-oM---M-------------BB---B----M----X-??-B--E------E----M-o-o--o-E-o-MX------E----Eo--o--E-----o-X---E--------B---X---------MX-Xo--v
o?--M----M?---?-----------M-----EB---Eo--o-E-ME?X-X-BB----?--B-M------?-----------M-Xo-B-X-------MX-X--------E-------EM-E-?-------B-----o--------?-MM--X-B-------o--------------EB-?-X-o--MMM---X--XM--X
Bo----M---??EX------oo---?------X-o---X-?------------E---X---XXE--M----X---B--EE--EE----E---------B--ME---o-E-B-X-----?B-E--?-------?--o-E----EoB-B-o-o----B--M-B--E-?X-X-----B----?---M-ME-o?------o-XT
|-MXX-------EM----B---?----B--M----B-------X--M----?-MB-XBX-X------BM-------?---M-?-----o-?B------E----o------M---E-----X---E-BE---XX-Eoo---?o--?---EMX---o---Eoo?-B--??-----M------XM-----------------X
-M--------X----BEM-X-?---E-M--XB---MXo----X----------B----------o------X-------X----XX----EE---------?----------?M---E--------BM--?--------o---X--------MX---B-----?---M-oX?oM-X--X---E------o-BM----EM-
B--E-?-?X----E-?M-o-----------B-----MB--------B-X-B--XXX-o------------MM-----B----------o-MEo--M---X---o---------------ME-o---------M?M--X-E--?---X?X-BM-o-XoBE-M-M-o-----X--B-Bo---?o-----M?---X-E--X-E
oBBooBEXX-------?---------E--X---B------?XE-EBBX-M-----X---------------E---o--BX-??---X-o--?E-----?----?BE--------B-X-E------------?--EB---Eo-Mo-----------EBo-MX--o------X--BMo--M--B--?-E-o----?-----?
m--X------M----X----?-?Bo-----Eo?EM------B----BE-E------MB--B--?XX-MBE-------M-----ooB---X--BM--------?---X------M--XE----M------Mo--B------o-M--?--E---XM-?XMo-XX--M??--?--M-----------E-------o-X---Eo
XEX?BEXXBXXXXXXXXEXMXXoXXBXX?XXXXXXBEX?X?XXXMXXXXMXXXBXXXMXXXEX?XEXXXoXXXXBXXX?XX?XXXXXXXXXXXXXXMXBXXXXXXXXXXXXXBXXXXXXXXXXXXBMXMXXXEXoXXXXXoXXXoBXXX?X?BMXX?XBXoEXXXXXXXoXXoXBXXXoXXXXXMXX?MXXXBoXXXXoX
