-?ooXXoE--E-EME-Bo-oX-XX-XM-B-?B-XB-EXEE-X-EoXE-XM--E--E-X-XoBB?XXBXX?X----X-oEXE-oEEEXo-M-oX-Eo-X------XB----?BMEXoEX-B-B-X-BBoEB?EX?XE-EE-o----EoEEXEX-MXEM?EX-X-XB-oEXoXEE-BB--XBEo-BE-XXBX-o-EXEo-o-
-X-B-E-E?-ME-B-oB--XEE-BB?EX---XEXBEoM---EEoo--Eo--EEE--EoB?X-E--EE?-EXoE-B?-B-EoX-E---XBo-X--E-XE---EMEE-EXEXoE--o-oEEXBoEEBBXoBEBEX-X--XEEX-E-Bo-X-?E?-EE-E-EEE-MEo-E-EEBEBXBXXXEEB-oEo-M-?E-XEEE-X-X-
-?EE---BX--EEEB--E-XE-E-MEEE-EoEoB-M-?Xo--EX-X-E--E--B-XXo-EMEEoX?X?o?-XBEEooBXEXXo?EEoX-MME-B-?-BE-Eo-Eo--X---oXEXoXE--?X-B-?X--EEXBB-Xo?B?Xo-Eo-EE--E-?B-BXEMEX?B--?Mo?E-XE-MoXEEoEBXoX-BM-EXB-BEX--X-
-?Xo?-BoE?oE-oE-X-XXX-EEXXB--o-EE-oB-E-E-XX---EEX?EBEEEEXX--BXXB-E-oBE-oXBEXXoEEo-X-E--XMX-XXoEEo?-EEXXXoMB-EXoBEM-XMX-EE-?XBX-X-XE-----MX--X-EX-XEEX-XEoXBX-E--EB-BE-B---oX-B---EE-EX-BooEE-EXE--o-?---
-Xo--XE--XXXE---EE--B-M----XEX?X-?EM---E-Xo?XoEXX-B-EMo?XMEB---EEXoM--BB--BEo-XXX----oBoM?X?MB--oM-?--X-BEE-o---XXE-oEo?XEXXEoEoXBo-oXE-XE-E-BMX-EX---MX-EEoB-EB??BXEXM?E-X--XEXBMEB-M-X-MX-??-X?E-E-EB-
-E-E-Bo-E-E--M-EXE--E---E-M-X-BXEoEX--XBMoX-EEBXB-E--X?EE?XoX?B--XBM?BX--X-B-ME-o-BB-EE-XB--XEEEME--EXB-XEXEE?XXBoo-EX--B--?Eooo-XXE-EX--E-o--EEXMEXXoEMEEBXX-oB-EM-o-?o--EXoB-E---XBXXE---X-oBXE-E-----
--M-X?-X-EoBX-?--oEBBo?o?XXEB-BBB-?---oMoE-XXoXEE-E-o-XXXXE-E--E--BBo-?oo-EEE?-BE--XM?-oE-E---o-----B-XXEX----X---XE-oBXX--E-oX-B--BXXEBX---EX?-EX---XEMXB-?EXEB--?XXM-EB?XoE--E-B?E-EXoEEEXEXBBXM-EX---
---XEXB?---E--o--XEE--XXXoE-oXXBEEEXXBBB-EXXXBXoEX-MEE-oXBEXE-XB-Eo-MBXEXX-XEoEEEB-BEXX?Eo-BX--XoB-E--EBXEXoo-E-XEB-X--X-XE?oooBEXBXE-XEX-?--o--E---EMX-?EBXEE-----B-o?o-EE-B?BX--X-?EX-BEXEXEEEEoB?-EXv
-E-EE?XE-oXBXXEEXoMBEE-XX-EEE-XXEEX--?EME--X-MBEXBEXB-XEE-Xo-EB--X-EXE----XBXMEEX-XXXBXX-Boo----ME---B---BEMM-E--EoBXoEEBX-?-XXM-M--BXX--EB-?-X--Xo-BXX---?XEXXX-BXE-BoEE-EEXXoE-B-EEXM-oXB?EEM?-Eo-X?-f
-E?---MXX-E---EXB-E--Bo-X-E-----o-oB-E-EMBEXo--EB-EXXMoXEEBBE-X-E-XEo-BEoEB-oX-?B-XBXE-E--EBEB-o---o--X---o-oXB-?-?-oEEE--o----oME-X-E--oXoM-MXXX--XB?E?E-oX--MXMXEo?-XoEE--o-?XEX-?MXMX-XXoE?-Mo-oBoXBf
-EBoE?oXo-EEEX-oE--EE?E-oE-X-E-BXo-EMoB--?EXB-MoX?-o----X-BXX?ooo-XXo?-?B-?MEXoXo-B-E-B-E-EE-XX----XE-X-XEMo-X-EoXo-B-BB-?XEBXEB-E--ooM-M-E-oX-XEXE-XEBEMMB-E?-BEEo-?----BB?-?E--?-E--XoXEBXB----BXXEX?f
-XXEEo-M-M-E-E-MMX?XE-EBE-?X-XEXME--?-EoBMME---oBEXEXX-E-E-Bo-?X---?-X-o--E-EM-X-XBME-BXo-?X?MX?-EX-X--MXE?X--ooXEMXM-oBo-EXXBXX-o?E?XEXEE-EBXMBM-EEXX-E--E?oEXE--ooXEXE-XXXBoo--XXEX-oXE-EE--E---X-EEEf
--o?X--Eo--BBE-oEX-EME-X--oXXooBEXEEMo-EX-----E--MBB----XX?BEE-o-o-EX--XEXXEBE--E-X-BM-XX--XX-E-oEoXE-B?X-?XXoXB-EXMEM-ooEX-o--X--EB--E--Eo--EBXE-o-oEBB---oB--M-BXMBE-EoX?-BE-X-E-EEBBooBE?-oX-E--X--Xf
-Eo-MXoX?XX-oBXooE-EEoXEX-E-BoXE--E-?-M--XE--X-E--B-EBXEoEBoE-B?XoooXEX-?XMXEX-?EB--BE-oo--E-BXBB---X-B---MXo-XE---EXXM??oB-EE----ooXM-X--X-E-X-M-MEo--oXEoBoEXE?MB?-X-X-BEoXEE-Xo----?MXMXoX-oBMEE-EEBf
m-EX-X-EXM-EoXEBoXX--XE-Xo??XEXEB-XEXEXoE-BXX-XEoMEX--X---EBBX?-M-B--XM-B-BEE?--XEXEB?XBX?X-X-XXoBBEEMX-XXXE-oXXo--XE--X-E?MXMEooE--?B-X-X--EMX--EEB-EoXooo-MEE--o-BE--o?E-X--E-X-EMXXBXX--oBoXE-E-XEXXX
XX-XM-XXXEB?-BBEooE--E-?B----?XEE---o-X---oMMoEEXEXXoEE--XE?-E-E-B?EX--oo-?oEXB--XEX---EX--oXEEBX--B--oM-XB-XXXBBo---oooXB?oX-XM-XBEE-E--?-X-ooE--B-Mo-MEB-EoM?XXEoEXXB--EXBX-E-XXoEEMEBEXEB-?-B--XooE-X
