M?M------MX---?---B-?Mo-oM-----o--B-----E-X--B--?M---Mo-M-----X--------------?o--?-M---oo--M---?---B-XX---ooo----M-E-------X-----M-B--B----?X--X-----------M--?----o-----oM------E--------E?-------BB-E-
----oXB---B---M--E--X-Eoo----o-M---B----XB-E-------X---?--?o?oX-E-B-?----M-----o--o-----?--XME---?--M-M-------?--oE---o--EE----MX----o---------o------Mo?o-X--X----o----------XBE--o--------E--o?X-----M
MEM-BX----?--B---M--MX-o?oM---X--X--X---M---B-B-MoX---o--EM-X------?-E--------B--ME-B-----?--oEE-B--M-MM------E--B?E--------?---M-BEM---?B--?---------BXEM--?----o----M---B--E---B---B-----oM-MBE-o?--Mo
BB--------E-----------X----?-o-X-----?---o?-?-E----?-----X------------M-X---M-X?B?-X-X?--M-B----BB---o---o---oo--E-X---E-XM--B---XMX--B----B---------------o--------?--X-----------o-----o----------B--|
X---------------o--B--??E------E----XE--oB-BX------?--------?o-----X-X-------E---XE--o-----EX-----M-Eo-M---?--------X--?---M----?---Xo---M?B-oM---oB-E----B---B----o-MBo-?M-X-E---?B-----M------?-B----?
o------?------M--XE?M--?-M---E-----M-----E--?-o?-M-----?-X---oB-BX??-oo?--E-MB---B?---------B-X---E-X-X-o-B----?---?------M-X----M------o-----?-X-M-B----M--XoMM----X-----X----------------?---E?---X--|
-----X--------X---B-o---E-------o--?-X--X--X---?-Xo-M----X-------E--?------X------X-E----B-XME---M-E?-----?B-----MB-B-X----Xo---o-M----o--------E?X-------?-X--M-------XE---X---o----M---EM-X-B-XX----B-
XBX-E----M-----E---?B----MB--E-----XB---BM--------MM-EMM-oM-----?-MB----oX----M---B-M--B---?o--o--B-------?-------o---E-M?---o--B-----?-X-?o--?X-------B--o-ME---E?--?X----B--o--E--X-B---?-XoM-----?--v
M--------B---?-?-E--?--o---M-oMM--E--?--oX------------?-o--EoX?oX--BE------E?--EEX?-E----?XM-M-?X--BX------E-----o-----------?-B--------oX---o-E--?--XX-X----------E-E-?--B---o--XX---o-X--B--E?X-----EB
o-----E--EX-------------o?-----oX-------B--B---E-X---MX--EB-o--M--B-?---X-----E--oo---E-----?---o--M-------E?E-----MoX----ME---X----X--X----M?-o----X-X-X-X--?---BE----?o---E-B----B-EX-?----?---?--BB-M
T-----E---M?------B----?--MB-------X---M----B-E-----------o--B---M?-BX-----E-XX--X?----B-MX--M-------E---------------------------oM--?-B-------M----------E--M-o---B-o-?---EX-----M-----B--?--o----BE-?-
E---o-X----E-EMB----M--------?----B--B-o--oXo---B---Bo---BB-M--Bo-o----X--B--M---E------XE----EoE--?-E-M----------?E?----------oE-E-MEM-B-MEMoEB---??-?----EB?----X---?---XEX---B---X----o---oo------EXM
E--X---M--MXE---X--B-MX-?------?---?--o----?-?-B-?M---------------XBo------oo-----?----o---MM---Mo----MoBX-o---------X---X---E-X--o-----Bo----o-E?---?--E--B-M----o---X--M--o----EB-MB-----?X----?--?-B?
X-X--M-o-B-X--------X---?-M-B-M-X?----M--oBM------M--BEoM--M----MX?--B--M--oB--MM-E----o------M-X---X?-----o--o--M?------XM---X--?--------E---?---B-E--------?-----X-?-o?----XEX-------?--EB-B-----BX--B
mM?E--E---MB-XoE--o-MX--------E--E--------BEMBB--M--MB-------------?X---------X-B--------------E-----oB----------o-M--X--??--?-E----E-E---BB--E--Bo---o-----BX---M?-----o-B----Mo--o-----E-BXo------Eo-o
XXXoXXXXoXXXoXXXXXXXoXXXBXXXXX?XXX?XXXXXXXXXXXMoXXXMXXXMXMXEXMXEXXXX?XXXXXXXoEXXBXXB?oXXMXXXXXBXXXXBXXXXEXBXXXXXXoXX?XXX?E?XXXXXXXXX?MXXXoXXoXMXXB?XXXXXXXoXXXEXXXXXBXXXXXXBXXXXXXMEBXXXoXXX?XXXXXEMXXXX
