B------------------------------------------------------------------------------------------------------------------------------------------------------------------------------------------------------X
E------------------------------------------------------------------------------------------------------------------------------------------------------------------------------------------------------T
T------------------------------------------------------------------------------------------------------------------------------------------------------------------------------------------------------T
E------------------------------------------------------------------------------------------------------------------------------------------------------------------------------------------------------?
B-------------------------------------------------------------------------------------------------------------------------------------------------------------------------------------------------------
E------------------------------------------------------------------------------------------------------------------------------------------------------------------------------------------------------?
-------------------------------------------------------------------------------------------------------------------------------------------------------------------------------------------------------o
T------------------------------------------------------------------------------------------------------------------------------------------------------------------------------------------------------v
TEB---X-M-E--X---------MME?---?o---M-----M--o---oM-X-----?B-X-BM--o--o---o---X---o--X-----o---M----E-E---M----EMB-----?--------?------E-??------?-B-M-Bo-------XB--X-o--o-?---X--E--o--E------o?o?-----?
|oBBoEM-----BE-E--------M-M--X----------B??---M-oB?-------X?---------?-----E-o--?o-B-----M-E--X--o-?B----------?---M-?-BXXX---oM--oM-E---------o-----o---o--?XM---?--?------?---MB-----ME?-E-XM-Bo-----E
M-B?----------?-oM-M--X-----------?-B---Mo---?----------?------MM-?--------?----MB---?o--------B-ME?X--------E----------EBM---E-B?XEX-----B----EX----o-----X--B--X-X-o---?EMB-B---E-?-?----MM--------X-|
BB-M---o-M--B--BX---EB-----Bo---X--oX-----X--BM-----------MM-E--E------X-?--o---oB------------?--------?M-?o-?--o?---XB--XE---Xo----EXE---oM--?-----M----------B--BMB-------o---EM-----??--?M-BEE------?
M----X----o-------o--oXBEM------EB-o------oM-----M--------E------B--X---M----X?---M-?BB-B----------B?-E---Mo-------------B?-M-o---o------E--?-XX-----X-B-----M--o-oB----B---M----E---------?EM--M-o-?--M
|-?X-----?----------X-o--B--M--o-X----oBoB--MBB-----B-o-----------X----oo--BEB---o-------o---X--BB---B---M-M-?---X-E--X--------EE-E---?----M-BB-?-M?-----EEo---M---o?--B--------M-E--E-?B-ME--B----o---o
mM--XB----BE--EEooMM--B-?E-oEB--oM-EXX?---B-----------?o--MMB---ME--E--MX-X-B-----o------------B-B?X--------o-------?---M----B---B---X---o--M-----XX---o-?----o-X-------?MM?oB--EE-----o-----X-E--X-?o-M
XBX-------?E-X-----Mo---E------MM--E-E----------?--B?M----X---oE-----?B--------o----E---BM-?--E-MM--BE--M-------M----M--------X--M-oBB-----EMXME--XMo---M-------X-----oM-?--------B-X-EM--oB----B-X?Xo-X
