--o----BX-oX--X------oo-----E---M--X-?X-----E--X----E-X------X--E-EE-Eo--EX-X-----?-----X?-BM-?---?o--X----XB-MM----M?-----E-?-X--E------------M--M-----?------oE----BEXoE--B-ME-------EM--X---B-Xo---B-
-X-------?-X-XXX---M----?MX----E-o-X---------E?-X------Xo-----X-?------oX---X-----X----o-E----X?-----------X-----X-B-----X-B----o-X--B---MX?--oX-X-----M----XM----oE------X--X---------------E--E-----E-
--?X----E-----BEM----?---o-X---E--M-MX-X-o-----MX--M-Bo-B-----?E--B-M-BX--B--B-o--MX-E-EB-------X-X-o------o---o--------BEo--B--B----XE--M----------E-------EoEB-E-----o-E-X--M-----X-----XX-?o-X-o??-M-
----EB--E-EX-XXEB----EX-?o--B-E-E---X-----o-o------o-------oB??X-----XX--?---?o---MEB----M--X---X?XX----EE-?-----X-?X--E----?----E--EB-M----o-o--o----E--?E--o---E--E-XM---XMM----XB?B--?-BM----o-oX----
-E-ME--X?-X-----X-M-?--MX----M--XX-MoXB---oX--o--B-XX------------oE---------------?M--o-X--------X-o-o-o---?---E--???-B----BX--M--M--BoX---o----E---X----?----oM?-E---?-?---?o---?o?--X---oXXM---??oX---
-?X-M-----------o-Xo--MX-------XEX--M--X--B--M--B--?MM?-?-X-----X-oM--------E----M-X-?E-E----E----------o-----XBX-X-X?-o--E---M--X?----XMoX---?-?o----E--MoX--E---X-B-B?------XXX-M----------Bo?--MXE---
------B?-X-----M-o--X-?B--XXB-----E--XXX---X----E-E--E---?--E--BB-oE-Xo--oX-???-MMX---Bo-EX----X--?X---o--o-o----B--ME--Xoo--M-------X----MB-------Eo--E--?----X?E---E---XX-X----M-X-MXX--M-X--M---M----
-----XMM----X---BX--X----E--?B?-X----M------XMX-?-X-X-?oB-XoX---X----M----X--------E--XXMX---?X---o---?o--EE----?B------M---X-----?---X--o---X-M----MX--oE-E-X-?M-----o-M--o-E------Mo----o---M-----M--v
-B--XB----X-o--?-X--?-E---M--o-X-X?---E------E-E------B--o-M-----Eo-XXX-----BXMX---Eo-BXX----XX--oB--o---E---B--o-?Xo-----EB-X-?--X-----?-----M-?------B---?-M---XMXX-X--XoE-E-E--EM----------?-MM--XXXf
---M-X----------o-o----EX-------E-o---------?-M-X-Eo-?----X?E-B-----E--Bo------MX--------X-M--X--M---o?------oX--X------B?-X----B--B----E-E----?o-B-M--?EMXE--o--EMoM---?--?B--BB-X----X---oM--XoB?----f
--o--M------o---X--XE----o-?---?------X-BX-B--BE-X---o----------ME-----oM--?--?---M--oE-----B-M-XE-o----EM------o-----X--MX----o-X-M-EX----------XEXX?---o--------E---E-----------?E---M--BX--?------??f
--X----------X--E-E----o-----------BB-----o-X-B-XM-?-?-M-BBB----o----o---E---?-------E-X-X--?---oX--B-B-X-------oo------?oE-E--B-XE-------E------X-M-o---XEM--B-E-----oX---X-E----oX-------o?X---X-E-o-f
-----oX---BXX-X-B----------X---?---------Mo--EB-X-M--o----??B-?---X---o---?----B----o-M?-------X-----X-EM---X-XE--X?----o-BEEM-----X---------X----------M-XB----M--o-----------X-E--------Eo---?X---M-of
-?--E--E-----------MM------M-XX--o-X--M------B---o-X-B--MEXo--M----X-X--X---------?---E--EX-X--X-?o---o?--?o---M----?--?-X-EE-M-?--M------XXX??-X-------E--?-----XM-BM-?--?-E-------?---B--X---oM------f
m--oX--M-XX-MX---B-M-XEB-----?-MX-o-X?EXoo---E----E---o---MXM-oXXX--X?--X---M----EEXXo--XX-----B--E------X?-XX----------E---------MM--X?------EE-?E------M?BXoX-----XX----MB---X---------E--------oo---X
XX--B--?E-E--X-------B-----BX?-B----?X-----M---XX--X----X------X------------Xo-MX---X-B------XX---o---M----?oE-XE---X------o-XXo?o----MX-o---XM--BXM-Bo-?X--X-M?-M----o--E---------?XXE-X--X--M----?X--X
