-------?----------o--B---E?---o----oE-B?---------EB---XM----X---M----oo----?---o-M------------XoX-X-o---EB-X-----B-EXX-?oX-----MX-X--X?X---oo-X----?-----EEX--X--X--XB-B---?M--o-MXB----B-M-------------
-o----M-?o---B-oXXXM--MEEX-M--M--B----B--X------?o-EX----Bo-X-BM-----E--Eo----E-X---?E--oE--X---BXM?--?------E-----B--B-X-XX--?----E--EE-BB---X-B?---o-X---B----E-o--o----M------E-E-----BX-M--oM-------
--EM--o---X-MX----B?--?--??Mo-B---o---M----------E--X-BM-X--X-X--XX----M?-------X---EX--o-M--o-X--X-----XEB-X-X--oB-----EBXXE-B---ME-X--XX--o?--EX----B-------M-B------X--BB----XBXB--Mo--MEM-X-o-o-XX--
--X-------ooo--XBX---B-XE---X------E-EE-X--M---?o-B---------?---------?--B-E?--------B--------?X?-M-XM?--X?-----------X--X------XX-o?---B-M---E?B--XoXo-?-----?Xo--E--E-MXB-----B??-?-?------X---M-E----
---E----o----B--X---M---MX------X--?E--?-----?X-o?----X-----MX--X-E?-----?-oX-MMX---Xo--EM-----------------?--X-----X---M-o--M-oB-?-XB----?-X-M------BEoX-?X---XBX-M-B----oM---B-----B--?-E---X-M---XM--
-----o--?X-oBoB--??--B-?--B-----B----M--o---o--?o-M--o-B-E-X-oM-X--B--?-X-?--?--B------?-----X-----B--EoMX-Mo-B-------M----?------E---?-------X-----MB---XX-------BE--?E--EM---X--o-------B-----MX---o--
--o-X--X-----?--M------XX------M--X?MMM-------Xo?B-M-----BME---------?---BM--XB---o--M-----?E---X---E-X--X--------B-X-?--EME----M-----B?---M-?--XXX--B-XM---X--M------B?------?-?--E--o?M---------X---X-
-XM-------X-M-X----X-o--o-----o--B-X----?---MX---B?-BXEMo-BEXo--?-EBo--XB----XE---XX-----B--?X--X----oE---X-EM------E---M-----EEM----------XXMB-----X---XX-XoX----------XM---EBo---oX-oo-EMX-?--M------v
--------B-o---------X?--?EX---X---------o--o--Mo--E--X?X-??--E--o--?MX----o--o---o-M---------------------------E-EX--B-E--E?Xoo---B---oX----E-X---XE-X-------o--BB-----------?---?--------?o----X-o-X?Bf
--?--?ME-X--M-?--------------?-?---E-M--E-----X---X-?--o--?------?---B-EE----X--XB---X--X---o--oE-----o-o-Eo?-----E-----?MB--------oB----B---------------------X-----oo-B--E---X-X----------M--XM-----Bf
----o--o----oX--B-----MB-o---MX---X-M---o--X--o--o--M-------?-BB-X?B--X--X-?---M-X-M--o-X-E--------o----o-X-XMEXE----X-BoME--X-------BX-----X-X-E---B--B-----Mo-XE--Eo-B----E-----EB?--------?MX------Mf
-??-M---o-B---X-B---XXE-?-X-M?MB--X--B---X--X---X-BX-----X-M----M-------M--------X--E---M----?-M--B-?-M?---EBEB----E-----X-----oXX-X--EMX-E?--MX----EB-----o?-----M--MX--Eo---E------B--X-?--E----X--M-f
-EX-----EXoXXX--oX-oX----o--X------B-Xo----XX?-X--Xo-E?----o--------B----EM-XM--X-o?--o--X--?--B----?--o------------oM-?E-o-----M--o--------o-B---XX-B-o-?X-?XB-X-B--X-X---M-?B--X-M----XB------X--X-M-f
-BE-------X--------M----XB?----M-----E-?o-------X-X----E--X-B--BX-XXX-X------?BXo---oXM---o--X-----o-M-----X---E---o--------?------MM-----M------X----MM--?--E-oE--------B------?------?XE--XX-X-?-BE--f
m---?-E-X-o--------E--?--oM-----MMM--M----?--oEM?E-XX-?-XB-o--ME--EX-----BX--M---B----BB--------------XE---EX--B-M---ME-Xo--X--o-M----XB----E-MXM----XE?M---?--M-oB-M-X-?--?B----------------oo----Eo-MX
X-X?--?--M-----?X-M?-------B-M-B---MX---E----XB-----XM-BM---E-X------E-X-X-o---X-E------?E-o-----ooE-X--o----EEB------?-E--------X-X-X-MX-X------?-oBX-o-?-?B-XX-EB-------X--??-EX---E--MX-B---B-o-----X
