--------------------------------------------------------------------------------------------------------------------------------------------------------------------------------------------------------
--------------------------------------------------------------------------------------------------------------------------------------------------------------------------------------------------------
--------------------------------------------------------------------------------------------------------------------------------------------------------------------------------------------------------
--------------------------------------------------------------------------------------------------------------------------------------------------------------------------------------------------------
--------------------------------------------------------------------------------------------------------------------------------------------------------------------------------------------------------
--------------------------------------------------------------------------------------------------------------------------------------------------------------------------------------------------------
--------------------------------------------------------------------------------------------------------------------------------------------------------------------------------------------------------
-------------------------------------------------------------------------------------------------------------------------------------------------------------------------------------------------------v
-?oB-M-XBE-M-M---M--?E-o--------o-M---BM---X-?-o------?-o-B----------X--o---------------B-X-M-??E---?-?-?-XMB?-----?X--E---?--E--E---B---o-----o------o-B----o-?MMo-------------------X-M-E----M-X---o-f
---E------?---X--------o-MXMX--o----B-XB?E-o-E--B-M-----?--oEo----o---?E--M--?-----------?-------?-o-?-----B-o--MM-----X??-----E--X-MM--M--M-?--M----?---o----M-----B---XM----?X-------o--BE--oE------Bf
--X-oX--E---B----X-B-?E--?-------oX----E-------B-----o------E-E---B---------M---MM----------Xo-------X---E-X----M------X--EE-X-o---X-oM-o-B---B---------X-o--X---X----?M-X-----------B--EM------E?-----f
--?-X--E-Mo----EMB-----B-XBB-BXB--o--Bo--------BB--B---BE--BMX-o---B--o-o---------X-X-o-?---o--o-E------M---E---M-?M-?--M--------o---M--?--BX----MX-----B-----EMXB-B--o-----XM---o---Bo----BXX-EX--E---f
--B-E-M--B-o?----XX-o-------X-----E---oBX-o-o--o-M-B-o---?------E--E---------X-M?--o--MB--?-?---B----M--?E-?E-X-?oo---------B------?-B-X-?--Bo-o-M--------------X---B-----?B-M--?---B-----EM-----EM-E--f
------X-X-X---E-oE----?M---E------B-M--o-Xo---o-M-E---?-EX?---?--?-XE---B--E-B--o----M-B----?B--XB---E--Bo--B---E?---E-E-----E---E---?XX-------XB?E---oE----------X----?E--M---?-M-E?---X--------X-E---f
mB-oo-E--?-E----oo-Xo-----B--o--B-B?-B-B------------E---M---MX-XXB------oo-Eo-XM--oX-oB--------?E-----BB--M---------------M-X--?-E----------?M---EBoB------E-B-X-ooM-M-X--B---------BX-BB-----B------M-X
X-M------------BM--B--EB------B-M--------o----------EB-M?X-B----MX---X-E?-E---------??--M-M--?------E-?--E-E----B--?-------E-------M-o----?-----M--B---?X-X-------MM-----E-E-M--------B--X-E-BEo-B--B-EX
