-BBo-XX?M--B-X-BBoo-XX--Xoo-?B--Xo------BoX-B-----ooXXEB-MX-MM---XB-X-Eo---?oB--B-BXX?oXXXo----B-oBX-EM-?-oX--B---o-o-X-MBX-EBEEEE-B?-B?BEX-BX---X---X-XXoo-E-??---------X----o--XXo--B-EXB---?BMX--??X-
-M-oB?X-?E--------?BMo-XB-M-Bo-EX-o?---B---o--?-BX-E--EMXXB?EM--B-EB--E-----X?--EEB--M-o?X-BXBM-B-XXo--BX?EE-?---Bo-o----EoM-----EB---X--BB-EXo--E-?-EB--Eo-M-X-ooEBEB---X----o-----B-oo--?-BXE-EBB-----
---BX?-------ooX-oEo----EM-XB-o---B-Mo?oBoB-E-B----E-E-X-X-oB----?-oo---EXXE-o-oXE-----o----BXEB?--X--E-?-X--B--E---B------------X-o----E?E-E--XBXo-E--E---X-o--B-M-?--ME-EX----X--?EX-B-E---E---XoB--E-
-Mo-?-Bo-BX-?-B?--?-EB---BB--E-EB--oEoEE-?E-?XBXXEM-----B--EoB-X-M-X-E---X-XBoEBXB-XoMBX------o?Bo--?BB-Eo?o-------X--MoM--EXEE--B---o-BoB--?-----BXE-----oX-E-o-EBM-?----MoX-BBEoB---?X--oM-oMo-?---o--
--EMoo-X---E-XB-?X--Eo?-B?--B?--X-X?B-----o--X-o---o?-BXMEX--B---?BBoB--X-X?M-?---B-E-MX-oM---X-----XM-?EMEBE-BE--BM----oXoE-Bo-?-oXB---M--E--BM-BBEX---oE-o-----X--o-E--X--M--E-?BMo---o-X---o?E--oX---
--B--E--E--E---B---M-BBX---BXXX?E??----BX--Xo-MEo---B--EM--?BB?MoB--E-X-?-X-BX-o-X--XM-B--o-EB-B----BBB---?---M-EoM-E-BX----E-E-BBEX-----oX----o-M---Eo-----E-B-BB--BXo-EBB----E--oX-E?--B-oo---B-BM-Bo-
----M-o--XB-BXXX-o---XoE-E-ooE-E?-EE----?-E-XBoXB-BX-E---MM--o-Eo---E-oX------o-EM--EME-o-oX-B--B?B-----MB?--o---oE-oXX?E?o-BBB---X?-X-MB--B--B--?o-X----E----B-?---o-E-ME---o-----EBo-EB---BXE?E--BEX--
-BB---M-oo--EEX-BMEX--B--oo---X---XEEE----B?-BBBoE?M--?M?EM-X--B--MM-E--EB-----oo--M-Xo--oE-o----EM-?----E----E-M-o-o?----E-?--X-o-XEoo-oXB-B---o-?-----XoBo-B-EXM-X?-----BXXoXXMX----E--B--E---X-----Ev
-MoEoEEo-EXXEo-X-X-?-E--E-B-M-EX---X-oXE-M-o--oX---B?-E-o----EBoMo---oEB--?M-B-E--XE---B-?B-XMXE-BoEE----B-BM-o-o--X---X-XBXEBM-E--X-E--o-M-E-----oMBB---B-E-XB--M--o----Eo?-EBX?B--BXE?MMM-X?--EBo-M--f
--XM-o--ooXBM-oB-?-B-BBoo-BE-oX-B-BM---oM--------o-o-EEXE------o--BMo?o---E-o---X-Bo---o-oXoM-E---B----E--?M--EX--o--?-BXB?-------XEX-B-B-oE-Bo-E---XB--BX-X-Eo-XB---EE-XoB---M-------oXM--o-X-B-o?-E--f
-o-BB-B-B-E---E----X--?-?-BB--E-BX-B--?X--X--X-E-M--X-?--E--X--XE-B----XE--X-XX-BoBBXXX?--X-BXB--X--M---MB--X-B-X---BMEB----?EEEEo-?----XE-XXo---o-------B-X-o---o-E---E--o?o-B--Bo---Eo?---BX--oEB-B-Bf
-----?BM--oBE?E-B?M---oXB-BEMBBEEE-?-X----BEBB---?o-o--B-oE---B-EXXE-----Xo--MB-X-?--EX-?--X-oMo--Eo-------B-oo-E-XoE--X---XBX-E----M--MMBMX-----BoX-B---X-X-X--Eo-Eo-oE?EB-XEo------EB??--o--EX?-BX-?-f
-XBoEo-X-oX-BoB-X-X?-E--o---ooME---?--E--oEB-o--M--EE------M---oB--?-E--o--M--E---B----B-X-?o----B---ooM?E-B--X-----B-X--X?E-o-?-oM---E--BB-XM-o--oM--M--MEM-E------o-M-X--?o------XoX-?-----o-o?-?--o-f
--XEEX-EB--??E-o-B--BXoEE?--?X---B--X-oX-Bo--?M-----E-o--EoE-X?o-X--o-E--EX-E-EX-XX-Bo-oo--X--BEE---BB--BM----?ooEBBoBEoX--E-----X--Eo?BoBEE--X-M----E-X----EBXBX--B-Eo-?X----?B--Mo--o-B?E-?-E-o-E-?M-f
m-B--o-MEBo--M----X?--E---M?---Eo---oX-XXo?o-E-?---B-o----o?B--X-?-----E--MX-o--X-BMX------oEBE------Eoo?-X--E?X-?-BB----X-BB--X-XBo-EM--oBXX-Mo-BXX--?-oXB---B-BE-o-XX-EEoo-XBX-?MXo-------?B--B-BEX--X
X-B-B---X---E-B--EE-Xo---oE--Eoo-o-?-o---o--BEEBEE-XM--M------o-X--B-----E-oXX-----?o-X?--EXoXXE--BEXXXoM?---?-E-?--X----o-B-E?-E-BX----E---------EoX-oBBMXB----XE-EoEEM-o-X---o-E--XBMoMX-E----E--?---X
