---B-?-----o-?---o--B------B-------?E--X----X-------oMB?--M-BX-BB--XXM---X--?X-----EE-----E--EX--o----X--B------B?-?---?--B---------X--------MMM----o---oX-----X-----------X-----o---o-B-B--EB--E-EB--B-
--E-----M---X-o---X?-------E--EBo------o----------E?--o----------------?-M----BB-----o-E--?-XBB---------E---X-?-----E--M---Moo-XM---X-ooB--E?-----X----M----X----M--oX-M-o--------E-E----E--X--X?----??-
----X----??o----X---M-----B--B---B--B-------XE--X?o?---E---------BEME---?-X--XXE-MB-?o------X-----o-----MX-----X-------------X--?----B------E----o---M------o---B---------B-M-----o--B-?----B--o--M--?--
-oE--B---M-?----E-E-------o----o-----X---?-B--o---------------X-B-??--E---B-------------M-------X?--BEBX-oXo--B---?--M-?--BB-E-oBE------EMo---------?-EM-----X-oM-------E------?M-E----M----o------o----
-?--o--o--------X--X-?------oB-----------?-?---------EM-?--E-B--EoME-M-o---E--?M-?-o---o-EB-o---B-X---B-?----??-E--EX----M---o---BX-oo-M----o-------M------------?--o-----Xo----?---X--ooE--B------?o---
----E--o------X-Mo--E--o-----------?---EB---Xo-EBo-EB----Xo-B-B-----------------?o----E---?--------EM--BX-M?-o----M-X---M----B--B----?----X-E---XEE----B?-----M----o--M-E-----M-X--------o?B--E-M-------
----XMX----X-----B---E------MEE-?-?E--B-??M----X---??--M---?----M-o-oo-----M-M---X------B--B---E?--------M---E----------B------?----B------Eo----X---EEo--B---BX-------o-B-X-EX---EBE--?-E---Bo--B--X-B-
---E--ME---o----------B?---M-?-E--M----XXM---MMM----M--o-------?--M--B---X-B--E----------EM-Mo-E---E-?--B--X-E-B-B-o-M---B-MEX----?X-X-----E---X--E?---X?--------------X----o-----M------?-----XM----??v
-M---E----M-----M--E-X?-XXo--oo---XB---o---oXo-----M-?M?-ME---o--?--EMo--MM-------?-------X----B---------X------X----------?E---E-----oo----B----?-X-X--E--X--BX--?---E----E--XM?--B----B--?-X-?oX-X-X-f
-B----X---B?-----X-E-ME----X--X----M-------B-B-BM-E-?o---X--o---M---E?o----B-------B------M-M--ooXE--------E-M----E--X-B-?---M?MB?EX--------X------M-B--BE---o---?----X--M------o--EX?-?----Mo-X----E--f
--B---X--?X-----M--X--?M-o--------X-?--M-----BX-------M--E--EM---M--o-oE-XX-o-E-E------o----M-B-----MX-----------B-M-oM--M?B-----?-o-?B-X-?--E--------o--------XM--------o--X---------?-X---oX-B-----B?f
----------X------o-B-E-?--M-----E-BM-?--------M--ooXo-E-----MXo---E---M---E---M--------?-X-----EXE--M----E----E------???---B?----?---?---?-o-E?---E-B----o-XB--o---E-----X---------o---EX---E---o--oBo-f
---------------B--------o----o--X-----B?-?---oM?--MX-Bo--ME-----o-----XX----E---E-----X-----B---EBo----M--X-B-o-E-?B-----o-E?---X-------XX----Eo--BX--?X--------o-E--?-XXE---oEEo-E-E-X---E----M-?--E-Mf
-?-?------?----?---------M-X--B----X-X--o-??---?X-X-?-E---X-oo---X--?E--BE--?--B---Bo-------EM----Xo----o-?-----o-??E---?EE--------o---------X---M-----X-?-E----B-----MXMMoB----X---------MM-BX--?X---?f
m-oEX--E?-E?--M----o?--------BX--o-XB-M-B-?--EME-M------X----M------------B-E---------------EM-M--?---?------EBo-X-MXM-------o--ME-----?oE-BE?MB-X---X-M-X-o?M--XX-B---B-B----M-----B--EX-------B-?-X--X
XM----B?----XME-------X----------?E---X-----X----?---X-o?B-EB-X-X-B----MX---------M-------B------o---------?-------?o--o---MB----E------oM-o-----E----X--o-----M---X-----M---BX----X--o-------B-Bo---M-X
