--E-X-Boo--X--M--?M----B-M---XXX---MM-E-o?---------M-EB---?----o--------X----?-----XBM---E--X-----------o--oBE-------?---?oX--?-o-B--BM---?--M-----E--?-?--------BX?----oM-----B---EE----------MX-o-E---
-?-M--Eo-----------E--o--oX------EM--B-o---M-----------Bo-MEB----o---?o--o-B----MX---BM--------o-MM---M---X-------?-E-------X?------E---o---X---o-o--X---M-EE----?E--B--M---------X--E-oo--?X----?E-----
----?-XXX---oo----oMo------E--------MB----X-B-?-B---M----B-----BB-BM--X--------E?-------M-E-------M-E-----?--o-B?-?---E-------o-ooX----------E?-----------E-----------?-MX-----X---oB-o--X----?---------
----X----o--EE---E---------X---B-o-M-E---MMM--------E--XM--BE--E-------o-----?EMo---o-M--B-X-----------oEo--E-BX-----M---MX-----M--o-?--?-M-----?---EE-?M------------?EM------------------o------?-o----
-?XX-X-o----o---?---oo-?-----?--?o-E----X-o-------o-?o--M-E-o---E?--------B-o---X-----M-----M-----X----X--E--B-X-?-----X--X--o-----------o-------BB-----B-oEM---B--o---------E?--B-BBB-----?B-M--?--?---
-------M-----o--o----?M---E-B--EE--E------E-----o---BM-o-B----------XM---------?---------o-------M--E-M-X------MMM-?ME-------M--M-XX-M-M--------Eo-BE---X-----B----oX--M-M---------M---?--o-o-------?-o-
-E---BMM----XX?-E-M-M----------?EoM-----M---?-----oE-B-BX---B----E-MB-?---B--?-oMBE-------?-?---B---?-XMX--E-----B----------M-MX-o-------ME-E---E--o?B-E------X-----B------M--B-?--?-------Xo-?-M-----?-
----XoE--EX---X---M-----B---B-?-E-MXB---?---oX-o--B-MME-BE?--X--B--BBo?B----B--M-B-MX-------o----X-o---?o-X--X?---X-M-X----Eo------E--?-----M---------?--E------B--?---E-----MEME---?E--XME----E-MX---?v
-----X------------E--?XB------B--------BE-X-E----B--B-o--B--?--E-----------B----?--Eo---------?EM-oB-----MXM------?-B-B----------X--------o-X----M----oM---Xoo-----?o--o-MEB--o----?---X--MoB-B-------Bf
-------MM-B--B-------M-----M------?M-----o---E-----o??B?--o-----oE-M----------XE-----MX-----E----?-----?--X---oB-BB--X----BMB-------o-?-----B-X--------------MXo--?-?-??---Eo------o-----?----XM--o---Bf
----o-B-M--?--X------M--XXB----o-M--E---X-M---MX----?EB?XE------?---?----B?-?----B---?--X---M--B----------X-X-B--oo?-----?-----B-E--E----?M---ME----X---?--M-----E------X-Xo---B-X--Xo-------?o?-X-----f
----M------o--X--X----M-E-X----B-----?--------------oE-?---?B---X?-----X----M----o---B---B-----X--------M--?---------------oMoE-o---------------o---ME-----?--B-XM--o---------E?----M---B-o-E-------X-Mf
-----oX---?-----B--EM--M---E?---X-X--?-oo----o--------?--B---BM--M----M--?--B---MX---X-oo-oMB-M---Eo--E-E-M?o?--M--X--E-----------?-------------o--------?--?------E----o----------E-----?--E---?B--?--f
---------M-?------o---?o-----?---o--X--oX-E----?-----M--?--X--------Bo---B----MM---X---B-B-------X--B-M--------X?----B-M-------o-----E----o---M--o---X--E-B-E---XX-o?--oXX-oE-----BB--E--X----MM-------f
mE-ME-X---To-X-Mo?----T-E--T-M-----X--?--TM-E--B-X--------Mo----?------??-X----T---oX----T------------X--BBo---oT---------BET?---------M--------E--B----M-oT--M-X----T----TT---?E-----B?--?ET---T-oMX?-X
XXX?XBXXBo|XXXoMXXXXMX|XXXX|XBBXX?XEXMXB?|XEXXE?MXXXXXXMXXXXXXXBoXMXE?XXoXXBXXX|oXXEXoXXX|XoXXXXXoXXoXX?XXMXXoXX|XM?EEXXXXXX|?X?XXXXXXXXXMXXXEXXXXXXXoXXo?X|X?XXXXXXX|XXXM||XXEEEXXXXXXXXXXX|MXM|XXXXBXX
