-BEoXoMoXEEB?EoXE-oE-E-XB-B-XB?oBo-X?EEMXXMEoEEX-EE-o-XooEB-EEEE--XBB-EooBM-?-B-B-E-XXXBBE--BB-X-EE-X-EB?E-XEEBX?o-XE?-?--X-XB-E-o-EEXXEMEB-o-B?--oX-X-E-X?X-XXEEEXXXX-o-BEMEXEEEE?BXX-?---?XXXoX-EB?E--
-XB--BXMoEX-XE--X--XoEEX-BMXXBoEX---?-X-X-E-MX-EME--X-BB?X-X-X?-EMB-X-BEEE-oBXEoXBoXEXE--oXEXooX?Xo--EX-EXX--BXoXXEoBE-oXEMEEo-EXX-MXBBXE-E-X-BBX-oX-EXXB?XE-X-BEoEM-EoXEXE-X-E-E-XXX?EoXB-M-X?oXEBX-XX-
-?EXXEEXoX-EEEXE--X--M-BoXEEME-XBMXMX-BEBE-EM--oX--MB--oXXX-X--EXEo?X---MEEXEB-oB--X-XoXXEEXEE-oE-B-EXX-?E-EEX-X-o-?MB-XoBXXEBXX-E?X-EEE--BEE--B-XMo-XX-----BE-M-XXX-Eo-MXB-EE-oE-E-EX-B-MEBM--XX?E?-oE-
---XXB--XXX--MBXMEB-BX---MB-XE-EB----?MEE-EE?oX--?B--BEEoE?E-MBBEE-oBooXXEXBXEXXEEBXBX-o-XE?-B-Bo-oMX-X-B-X--XEE--E-oBo----BXEMoX-EEoBoXEX-EXEBEE?-X--BXXoX-E--BEEEX-oXEoEE-XXXooX??MEBo-o?E-X--EM-E?Xo-
-Eo-M-X-E-X-B-oM-MX-BXMBE-XMBM-EEEo----B-?BEXBXo--oM-E-o-BXXX-XE?B?--EB-X?-E-X---X-BE-XoBXE-Bo-XB-EXXE-oXEXEBX---X-?-oE-XXX--XMB-XoMo--XE-B-XXXEXXB-ooEo-XBo?o--XEXEEoEXXB-----E---MB--EXXEX-EB-M-XX-E--
-E-oE-X-XE?Mo---oEB--EB-EXoBXX-MXEoX-----XMMEEMME---MXXMoXXXB-XXB-EB-E?M-oEoB-XBMX-oo--?-oEME-EoXB-o-EXEEo?E-BX-E-BXXMEBX--oMXoBX?-XEM-XEEB---oE-E--B--B-o-E-EoE-o-o-oEXXoX-----XoX--XEM-oEE-EEE-B-oEoE-
---?XX-E-----B--oEXME--EB--XMX-EEXE-XBXEX-E-X-XoXXXEX-EXE-?o-oXXX-EoBEEoX--EXB-B-o-XXBooXEo-------?-EoXEX--MXoXEo--X-X-X-B---oXoXEXBEE--oEB---E--oXBE-XEMBE-E-X-XM-E----oXBE-E-X-XX-B--EE-EEo-XXEEo-o?X-
--EEXoE-XEo?BEoX-EEB-B-XEXE?XE-BXE--MXB--oM-M--E--XEMXXX-?----?BE-XE--o-?-E-?--o-XX-MXBMBEXXXBEX-E-Bo--X---BE-B-EXE-B-M-oEMX-X--oXo-B--X--E-EBB--?oMEE-EEEo---E--M-XXX-X-oX?B-XM-X-BXXEXB-M-XXXBEX?-XEMv
-X---XoBXM---Xo-oX-EE-EXEXEEE-XEE-X--E-??Bo-oB-EE--Mo-oEX---?BoooBEMMB-E-E--X-XEEE--Eo-B-?BXM--X?--XEXB-o-BoE?-X-XBB-XoB?XE-XBEXEEoXBoE-EEEEM-BEMEME---XXoX-X--E---M--XMEE-XXEEXXo-X-?Xo-XEMXEXBo-XMEBEf
-?EoX---oMX?-MX--M-X-X-XEMEEMo-X-XMEoB-----o-o--EEX-XEo--EEEX-EE-EBE--?oX-XE---X-EooEo-E--XooXMEEB?MXBXE--BoXoX?o?EEXoBEE---X?XEXXEE-E-?X?XB-o?XXXBE-oX-X--XoEB-XX---??EE-XBMBXBEXMBXXoBEBE-------B-XoEf
--?-BXEBEEoE--?--E-?XB?-BEBBX?BEXE-B---BX-XoX-X---X-EBoXE--X-XX---X?EE--?XX-?-B-BBEoMXEEXoXEX-oXM-E-M-E-Eo-X-XE-X-?XoEE---o?---?--MEXo----EE-?---?X?EE-EEM-?oX-EXoEo?B--EoB--BBBoEMBoXoX--XMXEXBX-B-X?-f
-E-XoX-XX--B-o--XMB-BB??EBEX--E---EXE?B--EXXB-B-X?o--XXXEXXM-B?-oXE-?MXX-X--XX?-XEE-EX-ooB-X-XXXXo?X-EEXo-XEB--X-EX?E-E?Xo--EoXoBoXEXXXoEM-XXEXEXX-B-X?oE?EE-XE--MX-EMEB-BooEX-oo?E-E-X---?MB--XoB---BBf
---BB-EEXX---X-E--EXME---o-E-EXX-XX-XE-BEE-Eooo-X-XEo---E-X-EoBE-EEB-?-E---E?EE--EEXMB-E-BE-BBE-B-X-?XXoX-EEBEXo-BX?Xo--EEE-?X-oE?XXE-E-X-MEEXX--oBE-XE?MX?EBooXMXEXB-?--BX----EEXXMBXE-?BBBEEo-X?EEEEXf
-E-XX--EEXXXXB--EoE-EE-XB-BX-B-EBBXBBX?E-B---XE--EB---E-XEBBEEEXBo-XX----MEBEoE-XEMoB--B-BEEXMMXXXo-?-X--B?XB-o--o-MX-X?oEEXE-XXX--EXEB--EX-EEXoEXoEEX--EXBXB-XEXEM-o---EoBoBE?----E-B-XX--EXE-?oXEEB-Ef
mXE-XX?-oEXMXMBE--EX--EXooBXXEEo-X--B-EoBXX-oo--EXB-E?XXM?--o-BXE-EEX--BooX----??XXXXEXE-oo-?X-XXBXo-o?X-X-----XMBE--EE?oE?-EBB-EXX---M?EoM?XE-E-oEEEXB--oXB-XBE-EE--E?--XoXXEXo-M---BBXXM-o---M-BEXEX-X
XEoEXEXE-X-XoEoEBXB---BXME-EXB-E-oXB-XXooXXoXEo--X-EXEBX-XB-EX--EoBM--oEXE--M--oEXEE-E-X-E-BoEEE-oBE-EXM-XEE-X--XB-o-oEE?-X-XB-oXEXM-ME-E-XE--E?X-EB-BE-BM-X-XBE-Bo-EEooXM-Bo-B-o-XoE-X-Bo-B-?EB-XXBEX-X
