--M---X-----------------o----o?-X----E?B-M--MX--X--X?-----E??--E-B--M--o-X------E----B--------MM--X---X---BB----?---M---?X--o----XM---B-B--?----------------E-----M-oM------------M--o------B-M----?--X-
-?-XB-B--XX------E----?---M--------?M----o--EBo--X--M?E-X------?--B?-X-E--------X---ME---B------------?X------??-----B-----M?--E-----XM---E--B------?-X?-----o----X--X---B--o----MBM-----B----------?---
--B-----X?-?-----------X------------X--E---o----------B--X--B-X--?------M--X-------M-B---------BXo-M-B------M-------M-XE--E--?B-E-E-------XB--?--?-?---XM?Eo--o?EB-X?XE-o-----------MX----E------E?-?---
------X--M---B---BE-------M-B?---E----Eo----E--E---XMo-------o-E-?-X--o?---B-B?-----Mo-X?--M---o?--M-o?-X-----------X-----Bo---B-EB---E--M--EB--X-E---X----X--M------------?---------Eo------B----------
---o-------X---?--XM--M?--M----?-M--------oE-----MXE-------B-EE--M-XE-----B???-----X--?-?--M----oo--------o---o-M-?-o--X--B------o--E---XB-o---?---X-X--E--M--M---E-XoMB---o---------X?---oEE----?----B-
---?--M----Eo-B--o---o-X------------------B--B-B--BX----------?--M--XB-X-----M----B---E-B--M-----E---B---o--oX---BE-----B-X----o-?o--oE--X--B--o----o?--------X----EXXBM----?o---------M-----E----------
--M-??--------o--------------E--------E----X---XE---EB----E--o--X-MEX--M-X----E---------BE-X-X--B---B--X-------?-o-o--------B-M-X?--B-E?--??-M-o?----Eo---X-B--X-B-M--E---M---XB?o----?M-M-BBBM-E-------
--E---o---o-BMEM--MB-X?o-----M---o-BX-o?B-M----B-X--o----oME--o--?---X-B-M-MB------B--E--MM---o--EM-Mo---Mo--X---X--o-M---o?-----X----XE--XX--o---o--XX-X--M-X-B--------X-o---X-oEo---B----o------E----v
---------MX--B-B----ME-----B?-B---------E-----?-E?---ME-E--X-X--------?o-------B--------?-E-----?-X--E----------E---M-X----?----o-EMoM??---E--X-?--M-X------E---?X-??--?-o----M---B--M----EoB---EE-----f
------?-----EXMX---Bo-E-?--BM--B--BM---B-X-?E---------?-X-----M---o-E?--?B-------------E----E-------------E-E--X-M?---?--EB---------M---B----EX-E-------M-o------o-E---X------M--E---B-X-Mo--------?---f
-----MX?Xo-----M?---------------oBM-M----M----X-EM---M--o----------oMX-o--M----------------oo-o-?-----BM--X----M---?X-B---M-?XM-X----MBE-E-E--B--?B---B--X-----M---E-E-B-?---X--------o----X------X--XXf
-M-----B--E--ME---M--?-EX------BMo-----Bo---B-E?X---M------M----------E-------?-----o--XE----------E-MB---E--E--X-X-X---X----o--EM-----M--XE--E--EE--BB-------E---oo?X-------------X-?----X---o--M--E--f
------?----o--MM-M---o---X?B--Eo----XB----X-------XX--B--EB-?---------?----------B-M--X?o-E--M--X-E-oEX--BM---------E---BX------B-----E-o-B-----XM?---X--B----o----B--------E----o--B---X-o-?ME------MMf
--XX-------o--X?-------MEo----BX--X-----?-----?---B-X-----X-EB---o-oE-?----X-E---o-----?---E--B---------------?--EEo--------?o--X?------B------o-M-B---E--?BoBX-X----o--X--B-------?--o----X-E-E-E-----f
m?------XM---E---B-BX--E?------X----T----o---o----Eo----X-MB--X-E--B?o--X--E-M---TTT-?X-----o---o?---XB-XEM-----M-------?-------?-----M-TB--T-X-E-B---?-----M-----T-M---X---------??------M------------X
XEXXXXXXXXXXXEEXXXXXMXXXXXoXXoXXoXXM|XXXXXMXMoXMXXEXXXXXXXXXXXXMoXo?XXoXXXXBXMoXM|||XXMXXMMXXXXXMBXXXXXEXXX?XXXXXXX?XoXXXXXMXXXXoXXXXXXX|XE?|XXXXXXXXXoXXXBXXEXXEX|XXX?oXXXXXXXMXXXXXXXXXXXXXXXMXXEoXXXX
