-XXX--XEE--E--o--B--X-o?X--E----M?--XMXEE-XE-X-E?EMEX--EM-E-EE?--X-oMEE-BEE--E-EXXoXoX-XBXo-?---XBEX-XXXXE--X-?BEX-XMEX?EE-o---XoBo--EEB-?E-M?E--o-MXE---XEEX--B?B?o?EXEX-MX-E?oXE-X-E-BXXE-EBX--X-oXBB-
-oEEX--E--BEoBEE?o--BMXX-o-EoXXoM-BEMX?XX-EoEXEXEX-XXBMo-EBBoXE-EX-BMoEEMBBoB--EE-X?EEoEBX-EBoEE-X-Eo-o-oX---XBXo----BMoo--Eo-MB-XXX?XBEXX--?---ooBBB-XX-M--BE-?BoEXB-X-MoBBB-XX--XX?EE-B---E--E?X-BXE--
-EXoBoEMo-XoX-X?-XEX---X?XMXoXB-Xo----XoB-E?EXB-XMB-XXEXEBBXX--o--E-BX-X---ooEB-B-X-XEEMX--Eoo-oEEEB-E--E-E?EEoBEEX-o--XEMXXXXMooXE-XE-XE------XXE-X--oX?o--oBoE-X?oXoEEB--B-X-E--EEEEoBE-Eo?oo--E?E--X-
---M-X-XXE-EE-XEEE-oXo--XoE--XBXX-----?EXE-Bo--X--XE-oEE?-XEXEE-EB--EEEoEo-B-?--BoEX-E-BEoB?XM-EXX?EoE-M-E--B-XXM-ooE---XoMoEB-X--oX-XEXE-BXB-EX?oX-EB-EM---?E-Eo-X-ME-E-EX-BEoXEEXBMX--EXBXE-oXE-o---?-
-oX-BXM--B-----B-X---XXXE--BE-X-EE??XE?-oXXooMEEMo--B-X--M?E-X--E?oBM-E-MEEBXo?---Eoo-ME?---X-BE--XEE?---X-E?X---XoEo-X-BBBEME-BEMoXoE-?B-XEX-XEBB-ooXEX-X-ME-XE-XXBXBMBBoE-XBo-XXME?XE---XXXB---EXEEXX-
-B-?Bo-B-?EXXX-EooBoE--BE---E-?XXX--X---?-XEE--?--ooXEoXoB-?XX---BMEXEX?E-B--MoE??EX--BXX--XB-MX?o?-oXooXo?EX--BBE-EX--EM--MoooEoM-oX-?-EE-X-XEXEXXBX-BBXXX-ME-EB---oEXEXXBEBEX-Eo?BX---BX-X----Xo-E--o-
--X-M-XX-E--oBEE-EoBX-X-B---?MooEE-BEMX-X?-XoE---?BoX----EoEoBXXEBo-XX-E-XoE?o---oE--oX---XBoB--EXXEE--X-o-XB------oB?--XoMXE---XB-E--oXoXoE-M---B-XBXoXEBoX-M--B-EEEX-XEXX?BE----X?E-?EMMX-BBEMoXoXo-X-
--EEXBX-?EM-XX-EBBX-oBEXoMXEo-E-o?E?EEM-E-B-oXEB-oMXE-?EEEoX-?oXE-oM-XEM--Xo-X?XBoooo-EEE-------Eoo?-oXo-ooXXEXXM-oX-BEX---EX--E?EXoXXBEEEEB--XB--XE-o?E-BE-XE-XX?XB-B-XBXXEE--XE-EoooMXBXBE-X-MXBXXBEov
---EB-EEE-EM-X-E-?-XEBBEoXEX-o--BEEXo--ooX-B-?-oE--X--E--MXBo-BEX-?X-XX-E-XXXX-EBEXX-B?ME?EB?o-X-X?MoM---XEEBB-M---XoM-oXo-o?--BXXX-EB-EooXEXEBoBEoXBEM-EX-B?B-E-XXEXB--BXX-BMX--EE-B-B--B-MEXBXBME--EXf
-XM-o-o-XE-M-BX-EBMEXM-oo--X--B-o--Xo?--XMXE-EMXXEB----EXME--E-?---oE--XMEEXE--XB-EoEEo-EEo-X-E-o---oBE-X-EE?oXE--EX?oM-EXooXEMo-E---oXXXo-MB-M----EE-M?X--EXooEo---BE--BEEE-oXoX-BoMo-o?-XB--?MoB-E-oBf
-XEX---EM--EoEXo-XXEEMM-E-?--XXBEXE-X-XE--BE-o--E-E--EX-MX?EX-E--o-BXXBXXX-BooXEXoX--?-Bo-o---XEE-M-EE-XoXEBXXXEXEX-XM-M-XXX-B--o-X-XB--BB?EXXB-XME-MXEE--X-X?XooEoEo-EX-oBXo-EE-XX-XE-oBooEEXB-E--EM-Ef
-oXoEB-MM--EE?BX-EMB--E-X?oX-EBMX-BXX??-XEBX-BBEB----XME-BXoE--o-XX---XBoE-oBEEBEoX-Mo-oo-BE-ME-EXX-B-EB--oME-MBXEX-E---EBEXEoBEEB--X--XX??EoX-MMBBoBXX-XEEoMEEXE-XXEXE--o-MXMXoBXE---?E-E-XB-XXE----o-f
-XE?-XEEX-X--EXooX-oXX-MEEE--EE-o-o-EE?EBEo-oEEE-oXoMoEB--oX?E?EE-BBEXE-XEX---oXXX-X-M-BEE?o?BXEB-X-XB?E--oE-oM?B--EXX-EE-XoXEo-X?BoXEXXo-EEE-E-o-EM?-B-EBBoXE-B--?-B--EX-EEB--X?X-?ME--Eo-B-EEX-oB-EXXf
-B---BoXEXE-X-B-ooE--BBE-MoXXBME-XBXEX-X-B-oXoMBE?-E-XX-?Eo---XoE-EBoE-o?o-XX??-?-EM-?--MoEX-XMBoX-M?E-oXoEXEEoXE-EEE?-BBE-E-XEM-Xo-ooXEoEooo-E-----Xo?--o--X--X-EEEX?EBEMXXX-XX-EXoX??-oE?X?XM-oEXX-EEf
m--E--MEMB-Eoo-MEXE---XX-E--B-E-BMXEoB-X--EEXBMBo-o-Eo-X--o-X-?B-XE-o?XXoE-E?---X---XXXE?--XXo-BX-o-oX---X-XoMXEoB--XEXE-EEM--M-XEo?o-?-o?EBXXB--EBE?B-B-EEEX-BXEX--o-BXE-XoEEEoXX-?X-X-X-EBBB?X-B-E-XoX
XBX-XM?XEoEEXE--B-?EoX-EEEM-EEEBEMEEEBMXoMo?BEoXXoB--ooEBoE-XEBM-X--EXoEM--E-EEXE--?EEX-B?o-X-EXXX--?EEo--EoX-XBE?E-XM-----oo-EBX--EE-o-E--oB-BXo--BXEo?-EXXBXEXMX-o-?EXXMM-Eoo--E---oE?EoBBEo??-BB--EoX
