B------------------------------------------------------------------------------------------------------------------------------------------------------------------------------------------------------X
E------------------------------------------------------------------------------------------------------------------------------------------------------------------------------------------------------T
T------------------------------------------------------------------------------------------------------------------------------------------------------------------------------------------------------T
E------------------------------------------------------------------------------------------------------------------------------------------------------------------------------------------------------?
B-------------------------------------------------------------------------------------------------------------------------------------------------------------------------------------------------------
E------------------------------------------------------------------------------------------------------------------------------------------------------------------------------------------------------?
-------------------------------------------------------------------------------------------------------------------------------------------------------------------------------------------------------o
T------------------------------------------------------------------------------------------------------------------------------------------------------------------------------------------------------v
T------o--o--?o---M-----o-X-M-E?--o------B----EMX-ooM-Bo-M--?oB---M----------XM-MoB---------M?---XEEM-------------EM---E-XE------B-----XME---oXo-X---M-E--M----o?---E-?----M--E---o--B--?BB--B--M-o----?
|ME---BE------o-?----B---??--B---o--M--X-----B--M------?--M-----X---E--oE--------E-----X-E-o-M----X----oE----M---E--?oo--M-E--X-Eo----XB----?-X-------?--MB----X---M--M---------------M-?--------------E
M-E-----X-----B?o-?XE-------E--------B----E?-X--E-------X-E---oXB----------B--------------XMB--------B--------------E--M----B-------------?-?o-o-X-XM-B---o--------ME-E---?--B--E-X--X-M---M---E---X--M|
B-o---?E-B-X----E--ME-B-------E-?--?EX-M-E----E----??---oM?BB-----MM-?---E?-----XoB----MM---M--B--B----EE?---EM-BX-E-MXE------E--------X--o------X--M---B--E--X---BX-XEX-E----Bo--??X-o-BB-?XX-Eoo--B-B?
M-E--X-----B--?XE--E--E---o--------E----B--MB-----------E---MB?B---oEB-------BMME?o-Xo------E-X---------oo-??-----Mo---E--B?--------E-----------M-B--B-E-oM---?-XE-B----------EBE----------MM--XM-X-?-EM
|-----M-------------o--M----XME----o-?-------?M-X--M-?--o-----o--B------XB--o---o-M?X-XB-o--X-------XEE-----X----oE-----?EXo-E------M----X--M-E--E--E--M---X------?--B-M--B--X--?----BX---B-M--B----o--o
m-o-------o-----------E-EEX----XoE-?--M-X-XX-------Xo-?--EB-B?-ooX----E-M-o---EB-B-XB----o-M-E----------E-?X--M---M-BBMoM--o-M----Mo---B----------o-----X?-X---------------?----X---M--M-----B-XB------M
X-X-X-----?-----E-B----B----E--EB-o-EX?---------o------------oX--------o----o-X-------MMMBX-------E--?--MMo------?--E----E----B--M-?EM-----X-B---o----?M-?------?-M------------EB---------E-----oM----?X
