-B----XB-E?--XEBXEXBBEMX---XX--?EBE---XBEE-MBoEXX?E?--XEX-BM-MEB--E-XEoEEX--X-BEX--?--oXX-o-oX?E--B----EX-XE-XX-EXoX?X-X-oXoBEo-BEXXEoE-XBE-??EEEEBXE--?XE-XoEM--XBE-XEXBEo--EXo--Eo-oBXB-BEEXE--EMXXXX-
-MXM-EEX?oXX-XX-ooX-XBEXB-EoEB-EEXEMXoooXB-BMM-XMXM-X-X----Mo-BEX-B-XE-oE?M-XEBE-EXEo--EB--B-BE-EE-oBEEE-E-XE-?B-EX--B?-X?-EB?-oE-BEo-XEE--E--XEXMB--Xoo--EoXXEXMXE--Eo-MoX-B-X-BM-XXE--EBBXMBo?ME-XEM--
-MoE?X?BoEXME-?Eoo-XXoXEXE-EEXB-X--E-EX----XXoE--oX-oEB-EEo?-E-BMEX----oXBBE-?EME--oEMo?-BBXEEB-XBEX--EXMMXE--oBXXXXM---?o-?oEX--X--XXEBXX-E-?B-E-B-BEXBB---oEoX-o--MB-----E?X---BM--E--E?XEEE??oEMX--?-
-EEoEEEEEBE?EXXX-oB-X?E-?Eo-E-?EoEo--X-oEXMEX?XBXXBEoE-XEE-B?oBE-EMXM-XM----X--X-Bo-B-?-----?-X--XBo-oMEEX-E-MB--XXE-o-BMXXB--oE--BBo----XMXE--BE---oEEEE-oE-BE---XXXM--ME--BoXE-XE-ME-E-E--EXEXBXE-BEE-
--E--Eo-Xoo-XoX--oXEX-E-E--X-BMEBE-BEB-?--X-Bo-X---X-Bo-B?XX?oX-EXX-EoE---?BEXEM-EXEo--EE?EXX-B?E?--E?XX--XEooEXXBBX-X-EXE--XEEB?E-oEXM-Xo-ooXEBBE--oM--X---EEB--X--o-E-EEE--?-E--E-XEMXX--o-E-oBo-BEB--
-X-X-?B-X-Eoo-B--EBMXEEoX--EXBMXoXXXoM-EE-?Xo?EBE--MB-E?E--BEEXE-o-EoEBX---oo-oXXEXX-BX--oXX-B--X-E----E-XE-Xo--E--XXo?EEXXE?EB--E-BXBE-?-Mo---B-EMEXo--Eo--o--E--X-EEEXM-XEEoEX-o---o-XEBMXX-MX-XX-oMo-
-EX?-EX-B----BXo-X?oB-BoXX??-Eo-EoXE-B?Xo-E-XoEX-E-o-E-X-X?X-X-o---EBXBXEXEEB--XoEM-EB-XEo-EXX--?XoX-oEo-XBMX-oEE?EX?XE-XXEXo-XXEXoBB?EoXXE--?XX-XXX--BoBXMEo-BEBX--EoM-EXXXEo--?EEEoE-?Eo-X--XXXX----E-
-EBX--X----E-BB---oE?EB--X-X-EXXXM?-X-BEX--oE-Xo-XX-EXX--X-BB-------?XEX-oEXXEXE-XX?BX-?X-oXE--BXM---oo?M-XX---EEE?-EEBX-E?-oEEXBX-XoB-ME-X?-XM-?-oX?EBE-BBoX-BXE-BXB-EoEXBoEXEEB-?--?-XXEBo?BoXXB--EBXv
-BXX-E-X-ooEEE-?--EX?o--ooB-EoBoEoE-XXX-X-X--XB--XE---BXEBEoE-oXXX-E?-X-XEBE-XXEXMoE---EXXXo-MBX-XX----XE-BXBXXEE?XXX?E-X-XBM-o--?EMXoE-MXB-X--B-EEXXo-EBB?Xo-BXE--XXEoBBoE--E-Eo-BE-oEo-XMEEXEoEE-EXE-f
--BEEooBX-MX-X-oXE?X-X-BEoXEo-B-XXXEM--BXBB--EoMXEX-o--oB?-BE-BoEXM--B-----o-oBE-B?M-EBEX--oXEBBB--EMo---EE--E-XXBE-o-X---EEMEEXMXB--EEoXEEX-?B-E-E-X-X-BEEXEB-MXXEM--EEoX?B-XEo--X--X--BBo?EXEBM-oXXoof
-M-EE--EE?o--M--E?MXB--X---XE?-X-B-EE--XEB-X--B-X?oBXXE--EXEEXXBB-EX--oEBB-X-EE-o-oXo??oMBXB-EoXEBo-M?--EoXBEX-B-MEooEXE---oXo-E?--X-?BBMXE----EEXBo---XM-BXX-o?BE-oE--E?-X---BXoMX-XoBX-E-?X-BBXXX-EB-f
--??B-E--MEXoE??---E--?XBXX-E-?Eoo-X-BBEX-oEoME-XEoE-XooBE-oBM?BMBEEEX-E?BXoE?EXBE-ooo--o-XE-E--X--BXXB--E--XEM---X?-?oX-X-EEEE-----BEX?--X-X--?XX-EE-X-Xo-MXMo-BB-EE-E-BBoEM-E-XEBXXEoEEBE-XXXB----oEEf
------BoBXE?MEMBEXX-o--XEXMo-EXBBBEX?EoXX?-?XE-XBoBXBMEX?-MX-E?-?--oXBXo--BE----??----XEEEEBEXoE-X-EEEEEXEB-X?BE--E-XEX-o?X--?oM-B?B---XoX--E-E-EXEE-E-X-o-M?X?BXB-B-?E-XE-oXXo-oEE?X-E-BX-X---?--B-XX-f
-EX-XEE-XEXoXE-X-EBBo-MX---XEX?X-E-EMX-EEE?XEE--XEE-EB--XX---EEB??oXB?XXMB--Bo?XEX?-?-EEoEXE-XEBE-o---M-XEoM-XBEEMX-oX?oE-EE-X-XEX-oM-XE-XXEXEB-EXME?BoEE-E---oEoB-M-X-EXXEEE-BEXoXBXXEMX-oEXMXBEM-BoE-f
m-MX-??Mo-oXMEEME-E---?-oBXX-BBX-o-EXBBXoE?-XBEE-BBXXoE-XEo?XEE--o--X-E-----X---XXBX-X-?--o--oX-MXXME-o-EMEE-XE---oXXMXEBXX-BB-o-X----B-EE-X-M-X-BEo?-XXXXX?XBB--BX---E-E-E--XBXE--E?oX-Eoo---MXB-oMXB-X
XE-MX--XX?EBXEX--?--ME-?XBEE-EXXXE-XEBE---Bo?X?EEoEEEX-B?Eo-oBX-X-Xoo--B--XE-EXXXoM----oEX--?MX-o-EBE--EXoBX-EBX--EXE-X-XMEB-EEXBEBoM-oBEX-EXXX-ME?-E--B?Mo-BBX-M--E?XXXBX-Bo----EEM??-o?--Eo-o?E-M-EX-X
