--?-X-------------MM---E-E-M--oE---E-----------?-------?B---o-E------?EM-M---o----X---M--o--EX-?--o-oEM---X--EEE--?-M-B--o-----?---E--E-E-----o-----oE---X---X-o-?-Bo----X-M-B----X----o----o-----BX----
-o--X-------XXo-----M-X---o---B----X-----------EoX-E--X----------MB--EM?--E-------B----B---?--M-E--M---X?-------XX?B-?---------E----o---------X---M-------o---?-M-E---X---o---B-----?-B---oE---?--BBX---
------oB-B-------o--B-E------M?--M-----E-E---E------M??-?-M--------MM------o-----------------?M--X----E----M--M?------M---------E---------M-oM-M--o-B-E-M?-M--M--o---ME------o--?---o----B-BEoM-B--M-?--
---?--M-E----M---B-M----M-oE-E---?-B-------o-----o--X-?-B--oB----o?o---oX---E--------BM?-oB----M-o-----X----?----BE--?--?----M----------E-M-XB--o------M---B-oEB------?-E---B--Eo-----E---EBM-E----M----
--M---EEM------B?----BB------o-XM-B--B---B---E-M?o-o---B--o-------??-----?---X--X------BB-----?---?----?--MX--o---------------?X----M-------B--X---o---Xo------------X------X--X--X-----------o--X----X-
-o--E--?--Bo-------X--------o----X-BE?-X--------EX------o---------B?-M----?----E--o?B-B-------o--B-?-B----X-----------M-?--E--M-----X-?-?------------------E-----?------B-B-?--B-------BM------XE----X--
-?---X---?----X-M----M-------?-B-------oE----------B--M-B-BXX-----ME------------M--BM---?--E-?-----?o----B-B----E------MMM-X---o?----E---oX-M---ME----?-?----?-o-------EE--E-M?-EMo--M---XoM---M--X-o-M-
-X----oX----B-X?E--M------XB??-Eo----------X-?--o-----?-------X---E-XB----------B-----?B--E--M-?--o---o------E--o--?-BM-?--EX-E-------X---X--B--M---------X--B-----oE----M?--X------E----X-----o------?v
---E--------o-M--o--E-----?X--------MB--oB----E-M---X----?--Bo--MB-o-X--BMo-o----o-------X------?-EM---M-EE--MM----B----X-----?E-o------?---?---B--?--X-E--XX-M--BB--?-------B--E-E-MM---o---XX---X?---f
-?--?---E----B-E--M?X-XM--X-M---------M--MM--M-----M-E----oo-EEE--X--o--E-?-?---------M-EB-----B---E-B-B-B-----?-B--X--B-EXoE?-o--?--BB----o-----E---o-B-------?--o---Mo--X-B---?---oM--?-MBX---o----B-f
------?--X-o-M---EMo---E----X--B---o-------?-XX-o-BMo?---oX-------E-ME----------XBE----E--?M-X-----o--B-o----B-B--?E--X------B--?-------oM--M-E--E-?----EXoB---o-o--XEX-?EB-M-------X-E-----B-----o-?X-f
-BX-----?E?X---o--?-o------E?E---B---EE-------B-E-MXo-----BE---MX---MX-X-X-BM-o?B---?-----M-EX-------MBEB-M--?oM-----E---E------?---Bo-----?X--B-X-?--E----E-----o--?--B---E---X--X---?-M--MMo---M-----f
-M--oE-----oo-------------M--X---EX---M?--o-?E--B-------EME-M--Eo-----B-?----o----B-BB--B-?-oX---B----------B----B--EB--?BM-B-B-X-----?--B----------o-------M------------??---o-?-M-o-?----X----B?--B--f
-B--MX----E----?-E--o?-------o--o-B------------B?-XX-M-----XEBo-o?oM-E---X-EMo-o--------X--B-------?----Eo---E----ME?MEBM----E----X----M------E--E---?--?---------E-------------?-?----M--X-M---oM-E--?f
mB-oX---XM----BTB---XB----oo----------T--?-----oM-----M-EM-?---T--M---------?-M-?---?TE---M---E-?--X----?T---T---T--?-MB-Eo--------?-B-----E---MoM-----T-----------?B-o-E-----?---X------------T?M-?ooTX
XXXXXXEXoXXXBEo|XXX?XBXXXXXMXoEXXXMXXX|XXXMXBEXXMoXXXBX?XXoXo?X|BXBMXXX?XMEXXXXXXXXXo|XXXXXXXEEXXMMXoBXXX|XXX|oXB|XXXXXXXEXBXXXXXXXMXXXEBBXXXXXXXXMXX?X|XEXXXXXXoXXXXXXXBXXX?oE?XXXoXXEXXXXXoXE|XXXXEX|X
