-?--?-------------?B-?-MEM-X----E-?--oM--B-M----------M---?-X-oXX-----------?---B-X-?--------?-B---?E---X-E-X-o--o-M-X-X---X--------E---E?E-?-B----------?-oXoEX-------E------o---B-BM----B-----------o-
--??-----X------o-?-E?--E--o-X-M--EM-X---o?----B---X-E-B---o----oE---E--EX-------XM-E-?B-XBXX-E-B--?---X--------E---X-?B------X----o---oXB----M--B--M?---M-X--o-X--M-XMM-E-XX----XB-----Eo--B-----oX----
-?---B--o-o-XB-X-E--------o---E--X-------?--B---B?--B--B-----MX?--------------EM------?-------M--EE-B--o--?---?-B-?M------o--X-------EoXE-----?XB----M-MMM---------B------o----BE-X---M---?---M-oME--o--
--------------M---------M-MX---X?B---?o-----X---X----M---X?--M-o---------E---o-B-----o-Mo-M-----X-----------?-----o-------ME--B--o---E-------?--o-X?---------X-----?X------M-oo------------BM-------B-M-
-?--MBE-?----E--M--------EB?---M----EE-----M-E?XM--ME--o-------B?------oE----E-MX-------E---X------M-?B----oB--B-X----?X-?------MM---Eo---?-----o---X--X-M----X---o-o-M--X---E----------B---E---o-------
----X-o-----B--?E--M---o-M--o-E--M----EXo--------M?M--E?X-------------X--------X--------M--o-------X?X----o-BX?o-?-----Bo--B------?---X-B--------E----E-----o----X-------X-E-X-?B--M-?----?----EE-B--EE-
-----------------------------?--M-B?-----EXM----XX---------------M------?--M-M---Xo----X-B------oM--BM--MoE-o-M-M---BX-oB-----X-oo--?----?--E---E------?---?-?------?XE-----E--M----oB---X------B-oB-?--
-MB---?--------MEo------B-X--?EM-E-M---oX---o----?-?--?---?-MX--B---B-----oo--o---o--X--M?--X-X--o----E-------EX-B---M-X--E--oo-----?o-E--E-E---oX-o-B--o----?---BM--EB-------M--B-?o-----o-----E----oBv
--------M--------E--X---?------?E--E---o?o---M---------------Mo---?BE--o-MoM-E---M-----E--------?Mo------MM--M-o-BM--X---E--B?----o?o-o-----oM--M-o-o--BM----o--X----B--B-X---X------o----------E--EBBEf
-------?---E---B-X--B----E---o-----------X--E------o-----B-------M--o--M-o-M---?o-B-?B-M-?----?-----------M----E---o----B-MM--M-X---o------XM---o----M-M---MX----X-X---X-----M-o----o--MEoo-EEo------E-f
-?-o-------B-M-?---MB---oM-o---M----------X-E---B-X-------X------E--X-E---M?----X--X-----X----?-M--E-M--E--BE-------------M----o-----?-E--o------E-oB--oB?----M?--o-EE----B---E---oEM?---?----X--B--E--f
------E--------E-----oE---ME---BM-------M-XB----EE--o--?Xo-------E-Bo--?B-?----EE--o--o--B--M---X-o---M----E--o-M--XoMB-----EoE-----------o----------M--E--o-------B?M-o------o-M---M----E-X------Eo--of
-M---?o--B-------o-B------------------E-o-------o--------?----?--X-----X----E-X-------?-??------o----E-X----MMB---o--EE------------o----?-o----?--M----------?---EE-?---o---E-B?E?----?---B-----M-E--X-f
-o---B------o--?BM--B-M---B-B-Xo---B--E-oM--B---o----o--------B-MoX-X---MM-B---B--MMoE?--B-ME-B-----BB---E--M---oXX--MM??--?M-X-----X---BB----o----B-oo-B--?M-Bo-------oX--------o----------B------X-B-f
m---o-BoX-T-M-E----ME-?M--E---E-----?---E------BT-o--X--BE-X--MoX-XM-B------Bo---X--BXX-------MToM----------E-B-E--?-------o---E-XXo---TX--E-oM?B---M-B---oB----------?------------M--o--oX-?--Bo----EEX
XE?MEEXXXX|XXXXXXoXXXoXXXXXXXXXXXXXXXMXXXooXXXXX|XXXXXXXXXX?EoBXXXoXXXXXX?oXXXX?XBBXXXXXXXXEXXX|?XMXXXXXXXXXXXXXXXXXXXooXXoX?XX?XEXX?XX|XX?XXXXXXXXXXXXXoXE?MXXBXXXXB?BMo?XoXXXXMXXXXX?BXXXXXXo?XoBXXMXX
