--?---XM?--E----oB?o-XX------X-?-?----?-------M--?ME----BBE--E---E-?-EB-M-----M-----oEo-?------M--EEEX------E-BM-E?---o----M----------BE----M------X-------E-----?---X-ME-X--?---X------?o-?----XEM--o--
---B-oXB------BE?--B-E--oB-EE---EE--M----M--------MM---------B-------MM---?--------o----B--E-EooM-----E--E-o-E-------Eoo----X-B---B-B----EXB---o-?---E--?--B-------ooX-M--------------o--BE-------------
-----?-Eo------?--M---B-?-?-----------o----X--XoX-X?BX---?-E?MX----E?M-----o-----o--M----o---E--o--B-------?-M?--------?-oB?E--?---M-EX-M----B-?--M---E-------EBE-------E--o-B?-----XB----------------o-
-----X----E---X-E--BB--M----B-B-B--E--EBX-----B--------M--E-?oM---------X------?-o?------E-o-------B--------oMX--E-----oo-E----------M-B----EB--X-o--M------X----B-?o----EE?B-?--?-E---?---E-----M------
---------?B--o--BX-E------E-?----------M-E----oo-----E------E-o---BX--E--oXM--E?B-?-E--X--o-X-X-?o--M-B--E-------X----?--B-B------B-XME--?B-o----B-XE-----o---E--B-B----??X--E------o?--------E?--B-----
-M-------E-o-?MX-B--M-----oX-?Xo-----o-----------?-M-----BM---E-?M-?-?--o-----X--EM---M-X-----B?--M--------MXo--o----M---------X---?--EXo-??--o---E-----o-------M--E---EB-M-M-M--M--BoXBE-o---------o-M-
-M?E-X-------E---M---B--------MB-EE----EB-----B----BE--B-?-?oE-BBMB--E----------?--------Eo-------BMXX---M---BB----o--o--B-E-oE-E------M--------------B-oX-B??----B-o--o--E---M----------Mo-----oX?---B-
-M--o-o---XX-B-oE---ME-B-oXB-B--M-----------o---M--?-XM?---o---?---M---BX-B-----MB--?B----X---?--------E----BE---M-----B--BX--o-o-B--o---XX?-o-oX--------M---o---X-B-ooB?o-----------oX-XM?--?X--M-----v
-B--M-----MX-o------?-----?--E------o---E----E-BMM--E-----MEX----X------B---M--B--?-ooM----E--E--B--M--o-B?---XMEE-------BX-?---Eo--E--?-?B--X-o--E---M---BX---?B-o----E--?-B----o--o-E-MB--E----M-----f
--E-B--XB?E-BM-E---------E---?--M--B----E-B----?--M----X-XX---M----M----Xo-?--B?---E--M----B----------X-----X--XoM---M?-o------B------oMMX-X?----?-E--?o-?---M-M--oX------X?-X---?-B--?-?o----?--o--oo-f
-E-----M-o--?-MEM------X-B-----?-oB-?------?E---M-M----BE-X--M--?---EB--------------------Eo------M-B--X-X-?-----B-----o-M--oo----o--o--o----M--------o---X------?Bo------?E--X---o-MM--B----oE--Xo-M--f
---------E-----------E---------------X-E---B-B----E---o------------?----?-E--M-EoM----E-----------o-?-------BBB-M--oE---------------EB-----------E?--M---M-oX-M-------M?---X----E--X--E-----M---?------f
------oB---?--E--o---ME-----?--B----o--X--MEE-Mo--E---------B-B-ME-M-----E-o-M--o?--B------B-o-----------M-EoM--o--M-------X------o-E--EX-ME-----?E?-M-o---oM-MXo-o--?---X----------XEXX--?-MX-X--BBE--f
-----B-MX--M--X--MM-oo---E------E----?-----M-------?E-XE--o--------E--B---B----?--?-B--X---------X-o---E----------EB-?BB-oo--o-----------?-------E-M-?----------?o------BME----------BX----X-------E---f
mXE-----M-o---BoB--o--E-----B-T-EE--------?----B---------------o----E---X---T-----------M------XMo-XT-?o-----T?EXEM--MMBM--?-----E?---o--E---?------------T---B--X-----B---M---------X----o----M----X--X
XXXXXXXXEXX?XXXXXXXMXX?XXXBX?X|XX?XXXXEXXXXBXMXBXXXXXXXXXBX??XXXXo?XEX?XXXMX|BXXEMBXXXXXMEEMXMXBXXX?|XXXXXoXX|?XXXX?EXXXXoXXXXEXXoMXBEoMXXXE?XXXXXEXXXBXXX|MX?XXX?XXXX?XXXXXMXXX?EXXBXMXXXBMEXXXEXX?XBXX
