-o-?XE-o?-EX-?---?BX--X---BM--oE-------?-----?-BXEE-X----EB--X?-oB---B---X-X-------BXM-o---XXEoM---?----E--?EB----B----o?--o--MB--oo?--E-Mo-E-B?BoE-M-XM-Bo--X--M----XMM--o---XMEXMXB-E-BX-------X-Mo---
---E?-XX---o--?---oEM-o--XX-X-?ME-XM---BX-E-?--E-BXB---EE-B---o------BBoEo-??-M-X-X--B---ooE-XM-M-B--B?---MX-E-E-X-oBEEo-o?E-EBX---E----o---E-------MB-EE-o?BM------oXBM-o--E-M-MXM-X-?EX------o----?B--
-X-------o--MXo-M-?MEX-B-----B-?--M---?--XM-B--EXE-EXB--X-M-----M-o-E-B----E-B-E-XB-?---BEoo-X-MEX---E--?BBEo---X-X-XE-EME--BMEoBXXX---XoXB---X-o-----BXM-X?-B-E---X-E---X-XE-B?XB--M--BXMM-B--X----M?--
-E-B--M-BE-X---XX--X-E-B-B-o--E--?--oBEX-o--XXo?B-BBoX--oXoBE-----?XM?-BE-B--?BE-E-M?-M-?E-B--B--EE--EBM--B---BX-o--B---ooE?BX--oo--X-?ooXM-X?-oX-B?---BE---M---o---oE-?-Xo?--XoM?E?EE-BEEX-E-----o-----
--X--?XM-?-XEMXEE----BXBo?B--?MXME--X?--BEoB--BEXMB--X--oM-XEX-Eo-XXo--o--oE-o-BM-o-oE-?M--?MMoMoo--o---E-oB-?--EB-BX-E-B-B------E--XEX--EoXEB-B-------o-BB-oBM-B-X------M--EEB-B--XX----BX-B-X-oEME-XX-
-o-oo-X---o-E?-E---E-XXo--B?--o?o-----E-E-oMBBX-X---EooX--B--B-X-BB----E-EBM-M-B--?EX---E--E--X---ooE??-?Mo--XoM--oE---BoBX---EM?M--?-X-E-o----o-MoX-o--X-E--EM------B---?X-B--B---E-B--oE-E--o--XMBB?M-
-o--B-X-BX-XoE-o--B------XB--Eo-M--XM-oEB---?EoB--o--EEX-------?-B---M?o----o------?---Eo-----E-E-X---X----EB?-X--B---?B-o?----EBX?-?-XooX--XE-BoE-EXXX-M---X----o-oXEB-XBo--MM-B-o---X-o-?----?XM-Xo-o-
--oX--X--?---M--?B-Xo-?oB--M-o?BE-XB-?-B--?X--MEXX-X?M-oE--BBB---BX?-EE-XXM---X--E-BBXo-B-----oX-?-Bo-BB?X-E--X-ME-X-B-o---o?-----o------?---Bo-B-----oo---B-EE----E---?-----E---BM---XXXB-BX-o-E--XBBBv
-o-BoE-o-E---XEB---EB-XEo-B-BMB---EXE-BB-B--B--o---o--oE----X?-BX------E-oM-BX---?M--EX----BX--EX-E-?-E--B-BB?-?Xo-----o-EBBo-B-X-oo-?-Xo-X-Bo---M-X---E-E--X-XBEBX-o-E-XM---B--oXMMM?-?-oo-B--X-?----Ef
-M-X---?B-M--B---BB??--o-B-o----EMoMMBE---X-MMo-X----o---EB?B---Mo-XEo--------X----o?--BMBoE-oE---BXBo-?EXB-oo-?-M--EBEBXB-oXE--E---ME-oMX---MoEo--X-XoXXoXM----Moo-?BX-o?--EX--Eo---E----o-o--BM-o-ooMf
--o-E-----X---o?----E-EXo-X-BB----E----X-----M-XM?X--EMXX---BM?oB--B---o-B-Xo---XooX--B--o--BoEo-BE-MoB-M--XBo--XoXE-----BB-E--o-oBE-?-BB-M----X-o---EE-----M-o-o---oX--EMM--X---ooBE-o-MMoEBXB----XB?-f
-B-XM?B?----X-?-BX?M?-E----o------B-?M---Eoo-?---B--EM-o-----EM?oBEB--MB----B--EoE-EX--Xo-MX-----?-X---MM--B-EE-o--E-?--XEBM--XEo-ME--oX-MX-?--o?B-B-----o--o-X-----o-Bo-B-E----B--BEoE---?-B-o--X--EX-f
--------X-Mo---oXoBoB-o-EMo--oX--o-E-Mo-o--XX--BXo--?--XXoB----EEX-E--X---Xo-B---o---E-M-o-?BBE--B----o?-M-?--M-M--BE--B-X-E-X--XEEEM-BXB-EEEX-B-BME-MXE-B---oB-oBE-B-o-oX-B-MEoB?--o-E-?o-EX----XB-X-Ef
-oX----o-----oB-XoB?--EXB?B--BE-----EXBBo--oM-o--M?-?-XB-E-M---------BB-XEo---B----?----X--B-B--E---B-o---?M--oX--M-EX-EEB-BB?oXo---BBBMBX?Xoo----?B-X--EoB--E---X?-?-B-M-XX---BEBo?-?M--B---------BB--f
m--o--BB-oB-EX---B-MEX-E---X-XXoM?-MoBXB-o-B--B-XEoXX-oB-XXEo??XM-XXBE-E----MB-XBo-XEEo-X?-B-B--BXXX-BB-oBBB----?oB-M-BE--B-BoXX-oX-B-o-EE-o-X---EXoo--o----?ooX---X-EX---EX-oX---o--------E--?ooMB-o--X
X?---X-E---EXo?---XX-?-BE-BX?Eo-B-?BE?-E-X---XEB--EoX-oXB-o--o?-BB-oBX-E-EX-oEXoM-oX---X--o-oB---Mo-E---B-M--E-B-X-E-B--BMMX-X-X-B-E--XXEE--E-B-E--E----X-XB-BB--?B-EX---M?--E--B-M--EB--oo--X-E---BE--X
