----X--------------------------oX--------------------------------o--o-----o-------------o-----o-----o---X--o-----o--------------------o-Xo--E---X---X--oEo---------oX---o-----E--X----------------E-----
----------X-----------------------------------------o-----E----------------------oEo------X---------------------o----------------o--------XE--E---------E---E--X-----E-E----o-XE-X-X-------EE-----------
-----Eo------o--E-E---X-----EX-o------o-oEX------Xo-------------X-o--E-----E----------------------o-------------E-----E-o-----------E------X---o--o------------------E--o------------------------o----X-
---oX--E-oEoX--X---------------X--------------------X---E---------X----o-E--------E-------o-----EX----------X----EE-------E--X------E---o--E-oE-o--E-------o---------X----------------X--o---X------o---
---------------------o--o------------X---X----------------X-----------------X-o-X---o----------E----E------------------o--------o----------o--E-------o-------X-------------o---------------------EX--o-
----X----X----------------oX------------X-X-----o---E--E----E-o---X-------E---oo-------X-----o---X---X--o--oE------E---X--E--XX---E------EX----E----X-X-o------E-E--------------E----E--o------o--------
--X----------o----------------E---o------E------------o----------Xo-----------E------------X-------o--E---o-X--o----X---E-----o-----o-------XX----o-E----X------------------o---------E-E--X-------XE---
----------------oE-----------o---oo-----XE-------------o--E--E-----EX-X----X---------o---------o-X------------o-----o--E----oo------------X------------EXE---o-------------E---X----o------------------v
----X---M?---M-----o--oB-MBE---E--X----?E-----B-E-B-----X?------M---?B--X-B-?------M----E?---M---?M-o----X----B-?--o--M-----X-E--o--o---?-E?--?--??--XXXX----XoBX------?EE----B-----?-B-----M-X------X-f
-----oM----X-X------E-------------XE------M--X----------?---?---E-X-----M--o-------o--E----B-E----oBE?--EM--M---X-B-?--E------------X--M---X-o--M-B-----oEMXE---X-E---o?-B---o?M--?-ME-oX?-M-X--------Xf
----XMXX-X------M----?M?--o---?--E-----X-X-Bo----X---B-MX---------?o---E-B-XM-E-----B----o-M-?B-MEo--------B-------?-E-----??-M------o----MX---??-B?X---EE----EBB-X-X--BME-B---EM-----oE-?---??B-E-B---f
---M--?B-M--o----o----o-E-Xo----------EE-B--M-----?------o------MB---E---B-o-----BXBX---M-------BM---o-?-------B-------E-------X---o?---Bo-E----o--?-?--oB--X-----ooMX---?---Eo---M-E-o?------E-----MM-f
---M-E?EB--o----M-XB---?X------------?-B----------M?-EM----M---o-----------?--E-E---Bo------Mo--E-?-E------EM?-?-o-----X--B-oXMB--M-o?----------o--M--------------X--o----oBooM--M-------MoXX----X-----f
-EEB-?-M-B-BE?X---MoX-EX--oBo-----?-M----BX-X----B--ME---X-o-----B-M-MB--M-BE-------M-BMX---o---------------XX-----M-----------o------------------M----------BE-----o-X--M----o--EE?----o--?--?-?----o-f
m--?---E---------BMo---?-o---Mo-?----EX--E-X--o-M?---MEXM-X-B--Xo---?----------o-----BB---M-------------M-M---BB---?X-?-----o-?o----??-----o--oX-X-B-o--------?---BXoX-------X--X---?--B-M--B--E-X--M--X
XXXXoXXXXMXXEXEXEXXXXXXXoXXXXXXXXXXXXXXMXXXXXXBMXXBXXXXXBXXXXXEXXXXXEXXXXXXXXXE?XXoXXXXXMXXXXXXXXXXXXX?MXXXBXXXooXEM??XXXB?XXBXXXXXXMXXXXXXXo?XXXXXXXXXXXXXXBXXXMBXXoXEXXXBXXMXXXXXXXBBXXXBoXX?XXXXXXXXX
