o--------?--M--------M---M--E-M-----o-o-B--o------------------E?E--M-E-----M-X--E-E-?-E-o---o--------B-----BM-----oMo---------B---B--------oM-o-o------------o---?o---?------E-E---ooEMo---?--X---o-?--B
MM-M---X------oo-----?---M--B-----o-------?E------X-X-BX-X?-M--?-B--MXB---?---M?-B---B---E--B---M--X?X-?----M-E-E-----o-------M?-------------o-------ME----?BX--E-?E----E---------------B--------M--?--T
o------------o---BoX-o-?o---?M--E---?---???M--Mo------B--B------XE-X------M---M-X---EE---o-X--M??---X-MEo---Xo-MM-------E-------X-o-M---X---B-----E?EXo-ME---?B-o----------------?--------E-----E-X--XEB
M---?--------X-M?-EE---BE---B----o------?--?-------------------E------MX--?M--E-?---MX----M---o-?-XXEM-----XX-oMM----M----B------Eoo-B-o-M--------XM-E?---o-Eo-?----o?o--?------?----------o--E?-?----?X
Mo---Eo---------Xo---E---?---B-B--?-?B--ME----?-B------------B----E--X----o?XX--BE-----XM-E-?-----o-----BM-------B---E?-------o---E-o-X-BoE----?---B--E---??--E--?-------?-B--------M-?E-XXBX-----Bo---B
E-------o-?--?------oM---E-E----oM--?-----o-------------------E----MX--?---B-BX-----BE?---E---X-M--X--B-E---E-Mo----?--M-E-----oEBX----E?-X-----?-?---------Xo-----XX-X--E---Xo----X?-BE-M--X-----?B-?B-
BE--o-B-E--M--X-------o--B?--?EBE---X---M-XB-M---o--M--------X-EXM-------X------o-MBM--B---------E------o-------oB--------------B--X---o---XM-BE---B-MB--ME?B-?-E--B-----o---------XooM-M-------oE-----M
|-EXXB----oo----------MX----B??M-M----E------?------B-?oMo--X-------------E-----B-E-------B--E-B-oB-o------------E--X?--B---------X-----M---o-oEBB-Eo----E---E-B---oMX---o---------?M--EB--X---EMMo----v
BB-E--o-----o----?-----?E-o-B----M----o-E----X-M?XX------------oM-----E-?-M---M------M--E--o-oo--?----X---M-X-?-M--o-Eo------M---E-M-E-X----MMMB----?EX---E-B--X-----------------?---M---?o----E-------|
X----B----B?--------oMB---X-X------MXM-M-o?--X----M-----?------E---X-B-M--o-?--M----o-MX---------?---B--E-----oo---E------oM?-XE-oo--?B-o--------oE-----XX------------EX-----M-X-E-?----oM--E---X-X--o--
E-o----oXo------X-----MBMX-Eo-X--------o----M-----oo---B-MX?-B--E-------BM------o-------o---------BMM---E-o--o--o---------o?----------XE--E---------------E-------M-?--?X---o----B---------?-------B-XoT
E-E-----X--oE----------M-B----------M--EB---MM-B------X----------?X--oo-----E--?---B-Xo-o---X---------------B---?---X----X-M-?BM-E--oEEX----B--?-------M?E----M--E-?EE--Boo----?----o-E----M-?M--E-----|
--oBXMEMX?-----B---M--------?-M-o---------?B---?E-----EE--EE-------M-B-E---?---BE--?---M-B----M-----M------?B-oBEX--?----B----M-?-E-E--------E-M--B--o----o---M--?------B-M-o?--M-?E?XB-B-??------E-X-Mo
o-o-----E----?-o-------B---oMoo----E-----X--------Xo--------?---M-B------o-----------------E-E--B-o?-----?----------XB----X-E------B---M-----------E---o---?------?-----XoX---M-----?X----B---MB-------B
mM--o-B---B--BB?----M--XEBX--XM--M-------B----------M---?X-o-E--------M-E---M----o-----?-MB--o------o----XM-----o---oM---o-?----B----M-----B--B--X------M-E--oM?-----?-MB-M-X--o-------E--E-----BM-XBB-X
XXEEXXXXXEXX?XBXXXXXXEXXXXMXXXXMXXMoXXXXXXXXXXXXX?X?XXXXoBEXXXXBXXXXEXXXXXEXXXXEXXXBXXXXXXXXXXXoX?oX?XXXXXXXXXXXBXXXoMXoEEXXXXXXXXXEXXXMoXXXXXoXX?XXXXXXXXXXXXXXXXBXXMXXXXXXXMXXXXoEXMXXXXXMXXXXX?XXEXXX
