B------------------------------------------------------------------------------------------------------------------------------------------------------------------------------------------------------X
E------------------------------------------------------------------------------------------------------------------------------------------------------------------------------------------------------T
T------------------------------------------------------------------------------------------------------------------------------------------------------------------------------------------------------T
E------------------------------------------------------------------------------------------------------------------------------------------------------------------------------------------------------?
B-------------------------------------------------------------------------------------------------------------------------------------------------------------------------------------------------------
E------------------------------------------------------------------------------------------------------------------------------------------------------------------------------------------------------?
-------------------------------------------------------------------------------------------------------------------------------------------------------------------------------------------------------o
T------------------------------------------------------------------------------------------------------------------------------------------------------------------------------------------------------v
T--o-EB--?--o--M-o----E-MX-M-------E-M-?---E-X---?--B---EX------EE--BX----X---------E-EM--E?--X---?MXEB--MX-?--B---o------X--o--M-EX--X--XE-M--B----X---E-----XB---M-M-M-X-?-X---o?----?---X--X-o-?--B-?
|?-?-M-?E---?---------oM--?BB-----B----o--X-?-o---X-M----------E-XMo--------------------Xo--B--?M-?-?--o---X--?-------M-----E-----?-----X-M-----?-XBM--B--o------E------X-E-E-X------M----X--------E-o-E
M---E--X-?-X??EB-o--?M---?E-X-------B--??-E-----X---XM-----B----B--?--XM---B-------EXME--BB--?-----o---??M----E-----o---M--------?-MM-oX-----o---------------E---o-B--------B-----X--?-------?o---B----|
B-o-o-B-EM-X----B--?-----E----B?X?-XE--E----o--------?B----EB--?----------EX-oB?--o----o----?-----o--o-------------X-?-M-B--E-MoBE--B-------XX-----X-E-BMXM------X--o-M-E----?o----M--B----?----B--o-Xo?
M-X-M-X------EB---------EEBB--Eo----------o--XBM-E----B---X--------B----E---o---E-B--o---EX-M---?E-XM--Xo--?---o-B----X-B-E---B-----B--E------XMEB-XM-?----M--X---X---?--X--------B---o----XX-?-??----EM
|-----?-B----o------X--------oX----M-X---------X-BM--X-M----XE-XX--B------B---o-M---B--EEE------?-BX-B-B--------B--EMX?-X-MX--------XX-B-o-oEM-o--M--?--------XM---X--B---------X---X--E--o--E-M-------o
m-X----Bo-M---E---------X--?------XE--E--E--B----------Eo------X--?E-X------------?---BM-B?-M?-----------MM-X-M-E----B-----------oX--E-B----B--E---E--oM-E-----M-----o-----?--B--oX-X--X-?----M--ME----M
XXX-------------M----XE-X-M?---?-?-?--M--?-M--------------M----BBM--?-X-----X------o?B---------?B-M-oX-E--XEM---BB----MM?-----M-----B---B-M?----Bo-oM---------?oo--X--E-?-----BM-M---------------ME-o--X
