-EE--XXB-BE--E-E--BEBXB-B-o?oMXX-B--Eo?--BM-EEXEBX-E-BoBXoXX--EEXoEEX-EEoEX-XBXXXEEB-EEBE--XEXX--E-?-MEEBXXEBBE-XBoBXMXoEBEXEMEME-EE-X?EX---EE--M-?BM-EoXBB-E-MX?BXEBBE-oEXXEX-B--MBXBBEX--o-oX--Eo--E--
--E-XMB-o-E--MEX-BEXEX-?EBX-EXX-B-?--BEXE-?EBE-X--BXEXEX-o--X---M-XEEE-EoEEXEM-BXXE-EEB--E--oEXo-E?-X-XBXEXXo-E-oM?-BXBXXX-BB-Xo--XEoXoEBX-oBXX?-X-E-BE-XXoXE-XEBB--M?--X?-BBE?--?-X-E---Eo?oX----MEXM--
-E-EE?EEEX?-------XBXBEEB-MEEXEMEXE-M?BE-XXBX--Bo-EEo-?-EMB-X-XXXoXMX-o-E?-XX-X-XEB--E--MX-BE-Eo?E-EXEEXEME-X-EEXXXX--BE?XEX---E-BXoB-EX-BB-EEEXM-BMBXE?oBXX-XXo?EE-X-EXX-ooEE-Xo-MXBMXM--??MM-XX-XE--X-
-X-XMEMo--E-E-XoEM-EXMoMXBXM--EEXM-X--MXEE-XX-E-E-B-XBoMEB?---X-EXMM-oo?XXoBooX--BBE-BBB-oEME-XB-E--X-oX-E-?X?BE-BM?-o--EMXXEX---E-BMoEBXXXXXX-BEE-XBX-o-EoBo?XBX?-o-ooMEEBM-MEXMB--BE-o-Xo-EXX-Xo---?--
-B-X--BBXo-EoEEoEoE-Bo--X-Eo-o-BXEoX--EX-EoEX-o-X-XEEEE-oX-BE--?X??--Bo--oMXEXX-X-EXXBE-B?-XXMo-o-XEX-X-MXEXBX--EE-E-oXo-E?-BXoXXo?-o--XX---?-o-EEoE-E----?BBEXX---XXEB-EXXEXX-XEXo?E-EEXoXXB-EoMBX-EEo-
-B-?--E-Eoo--E-MX-o---XE--B?X?BXXBEE??EooX-E-XoX-E-M-EEE?E-oXBEB-X?X-XEoEoBMXX-ooX-o-BEXEE-oE-XEX-o-BXMoE-EX-XE--oo--EMXX-E--o-EEEXBoEo?EX-EXBMEE-XXXXME-ME-oBEMEB-oo-oXX--ME???-BME?--EE--X?--XM--EXEB-
-B-XXEX-o--EE--X?-E-EME--M-XooXEB--XoX-?EBEBXX?--EXE---EEEB-XEMoEEB-oXEoE?-EX--o-MXoMXE-oM-B--oE-BEE-EEXME-BB?oE-MoE-XEEEo-BBEXoE--XX-EE-X-E---EX-X-X-oXE-?EB-BEXXMB?-XE-BoXXoE-EXEXEXEXE?XE-E-B-E-EXXE-
-X-B--XE?--EEoBEo--B-oXBBB-EoXX---E-BEX-XX??-o-o?E--?-o?M---X?Xo--X-XX?E-EBXEXXBBo--oB-XXEXBXXoEEBM--E--EMXX-XEXX--XXE-?XBoX-EBEMo-X-EM-?o-B---M-BXXE-?EX-B?BE-oBX-oX-o-?EE---XX-EMXE-XE-BEE-X-----EXXBv
---E---XMMo-EE-EXBXBMXEX-B-o-?XooM-E--M--EXXMEX-oE?X----EXEXEXoB--o-oo--BEBBX-XXEE-oBMoXM-X-EE-X-BE-EB--EXoo--XXXEo--BBo-E---E-EEX---XEo-oXoEMo-XB--?oEXEX-E--XE-MXBE--E-E-o?B-o-X--M--X-X?--MoXMoBE?EEf
-E-XB---XoXBX-M-MXoE---X?EMoXE??-XEEB?X---X--XX----X-oXXXBo-XEoBEBE-EX-X-EBX-MXEX-EoXoo-XXMX--?EX?X-XX-E-M-BB?XEX-BBEB----XXEXEEEEXEo?-??-X-B----?oB?B---?XoX-o?E-B?-XE?X-EoE---E-XX-?XoB-oB-E--?-M-XoXf
--EEE-B-EXXo?MEX--MB--MEBBXB?E-oB-B--MX-BoB----X-XXE-ME?--B--BE?ME-?-BoB-?BEXEEMXB-X-BM-BoXBoE?E-XXE-X----B-o-XMoEMXE-E-?--XBBEEBoMMX-M-E----E-Eo?--EM?BMoE--oo?XE-o-XMX-X??EXXX---XE---B?--Xoo?EX-XXXBf
-Eo-oM-BXoX-XB--XBo---oX-oMEEoM-EBEM--M-ME-XEBE----XEB-EEEE-XX--?BX--?---?----oEE-MXXEBo-E-o-XE--XB-XB-?---EXXX--E-Eoo--Bo-E-EBXBME-XB-BoMoXEXo-BE--M-XE-BoEoB---XBEE-XMEE--EEE-?-E-E--X--BEBXEB---E-XBf
--E-oBEo--X-XE-?BE-XXX-XEB----E--BEXEE-Xo-MBX-BE--XEEBMBB-MEE?---BBX-BBXEoXXE-E--oEXE-E-BBXoo---EX-E-XEX-E-?--X-XEo-B-XXE--E--?o--EE-XEoBEXE-X--?oME?MoXXEEooXXXoBE-o-oEo-EX?-E-E-EX---BBoE-??oEEMoX-Xof
-o-?-BE-XX-o-o?XoE-XMEXXMo-Xo-EEB-X-o-B-?EEMXoMB-o-oXXEB?EBoMX--BE?oE-?XB-BX--ME-EXE-EB-?X-EEBXEEEoEBEXEoo?oE--EE?--EBM---B----ooEEMX--M-EX-oE?--XE-E--E-BoX-XEEEX-M-E---X-BM-EXBo-oBXEMMEE?X--E?ooo---f
m-M--XE-E-?MoE-BXM-XE-?XBMBXX-XEEBEX-?XEXE?MoBB?Eoo--X---XX---EEo--?o-?Xo-E-EB-XBE?EoBXBBXEXEBXEXoBEEEE---EXM--oBMM--XX--X?X--M-EXXEXMBX-EXB--E--XX?--EBo-?E-----oBo----B----B?X-oB-o--XEE-B-M-EX-MEEooX
XEMEBMEBoX-X--o-EEoX-oEM?o-X-oXo--E?--EXXX?-XEBEX---B?-EXXE-Eoo--E-EEX-B-EEEME--M--B-E----X-E----XE-oE--E--oXE--XEXX-B?E-XX-X--oBE?--X-M-EXBEEEX-E-?o-X-MEEX-o?E-E-o--M--EEXEME-XEXBEoEX---B--oEEE-Eo-BX
