--E-X-X--X-E-X---BoEXXX---?MX----------EB-X--oM-o----o----MXX-B-------X----Bo--X----EXE---M---EMM------o------B-BM--XX--E--E--B----X-------X--EoME-B--o----M-X--o---M-o---o--M----Xo------oB--MXB-X-X---
-?------o--MEB----o-X--ooX-o-XX---X---?o---M-X-EBMBoBX-?B--------?EXM------?-------BX--M------------EM-?---EooX-----M----X---XE----B---?X--ME-------XE-?---BX--X-?B-?-MX-----EEo-----?-o--X-X--E-o-BM---
---XX---XX?X-B---B-MX-?--X------o---?M-o-----o---?EXBXX?X------o--------X-EB-E-X-E-----oM--M-E---X-----?-----B------E-E---E?-----?EM-BE?-------o---o----M-MoXB--X-----E----B-X-?---?------XE---E--E-----
--X------E---X?--MM-X--B---B-?XXooE----------EBX---------BE------?------o--------M---E----M--?-E---?----E--X-E--BB--XBE-------X---o-----X---XBE-XXX------X------?---E--M-----o---------E?-M?--B---------
------?XXB?----------?---X-X--B--B-oE----MXX------X--?o-X---X-E-X--o------?------E-B---XB-?E-----B-MBM---?-B?---Xo---E--X-X------M-B---?---oX----MXX-E-X--X-Xo-?o------MB----o?---X-XXX-XX-X-?-E-o----B-
-X-B-B--M-M--oBX-E---M-M-X--o-B-B-------------?------X-X-M-X-----EBo-BX?-X-?E---?ooBoEX?-M?--M-X---X--?o----M--o---------E--BM-X-X-EE-M-X----?---?----?-B---o-X--M---E--X--X------XX-X?----------M-X--M-
-X--M-X---?B---?----M----X--------------B----B--E?o----EE-o--X------?-o--M--?---oM-o--X---M-------MX----?X--X--X?---E-B--X---BE--B-o-B-X-X--?M-E--EXEBXX----E--XM-o---X-M-EM---------X-oooX--X-XE-E-X---
---M-?-E--------E---B-?-E--?E-X--X---X--XB-oMM--E?M-M----o-XE---XMo---X----M----EB-XE--X?XX-M?--MB--X-X-------Moo-o---o--X--M?-?--X-M-EM-MoXE-o---X-M-B-?-----M?X-?E-X-X-?-M-XX-E-M----?M-----B-o--X--Bv
--E-?--M--M-E-X-BE-M--EX------M---X--?-E-M-X--B----o-------Xo--oB?---o--Bo-??-E-MMM?---X-----X-B--X------B-?----X---BBM-----EXB------------B-oXBE-----X?-------B-M-o-----B-E?--?--o--------M-XBMX?-X-o-f
-----o-o---X---M---o-XE---?---?X---?--X--E--B?--E-X--B----E-Xo---X---oX-X-oB--X-M--E?---B-M-M-o--E?--E--X--o?-o-----B----B--?---B---X---E---o--o-E-o-?X-BE------XB------X------BX--?--XE--MM?--B-B-----f
-M------o-?M??--X-Xo--?M--E--XEX--M-M--o-o--------X--B--------?-E--o-X--E-----M--X-----B-oMXM------X?-?X----?E-M-X--E---M-M--XMM----XMMB-X?X?--o-o-X-?X---E-----BX-----M--o-M-X----?----XEoEMB?Xo-M----f
-E-?----EE-X------B-----EX---XE?---------B-----E??E?B-M--B--M--X-X?----??E-X----?---o-----o--?---X-E-B---?EE--?-----o---X?-------o----X?------o---?---?-M---o--o-?X------X-E---M---E-----E---E-B-M---M-f
-MBo?--?EEBE--o--M----------M-X--------M?-M-XE--X------oM-M-------M--o-oB--?o----B-ME--BX-----X----?X----M------M--------M-?---X------oE?XX--M----M-----XB-BBE----X----EX?MX--XXX--?-?---o--X---B?-ooX?f
----B--E------XB---BX-oX--o----o?------X-----Xo-XB-ooM-?---E-----?---oE-------o?E---o--X----?-o-BE----MBX----------XM-oo---M-----B-MX----B----X---BM----MM--X--B--XXM----B------o-----------o-----Mo--Mf
m--oXo-MMXX---?-----?EB-E-X---ooM-?---XX---X----Eo--?-o?-o-----E---ME------?o-B--?--X-------------M-------?X--XE-B-?o---E---E--B--B-M-----XB--M--------X-X--B-XoX---?--XX-?--?-XX-X---B-----BE-X-M-BB--X
X---?----XE---E-B?EBM--ME-E--------o--E--X-?M-M----?X-B---E---------o-?-E------X?-----M---B-o---E-o-E------?---?----------?MB----X-E-B---?--X--oE---B-XE------?-------o--M--E---XB-X-X-B----------X-M-EX
