-BX-EB-BoX--X?---o-MEoB-?EX?oMX-MEXB-XE--EXoooE-XE-oE-M-?EXB--XX??EBo?EXEMXoXXoXBoooMB-BE--BEEB-o--XXE-BEEX-EEE--EEEB-E--oE-E-XB-E--EX-?ooX-E---EX-XX--XXM-XoEo-B-?-XEBXEBXo-E--?-?XM-BEBo-XXEEEEXoXXoX-
-E--XXB-oXEoXBEEB---?-E---XX-X-EM--XE-X-EEB-EE-XM--XE--?XEXE-B?-BE-E----X--o-B-E-XE-XE-oXX--E-XXE-E-B--XMEXBBEB--EM--o-BE-EMXXEo-B-XoEE--BB---MXE--E-XEX--XXXoB-?X-EBEX--oo-oXXEoEoM--oX-E---X--EE-MB-X-
-B-BXEXEBEEXE-Xo-?oMXBBX--E-M?-XX-X-?MEEXX?EEoXEE--B-EEBB-XXXE-BXoB-XXE-ooXMEoEXoEE?EM-XE-EoBX-X-EX---B-X--?-EoBBoo-BoEE-EE--?EXBE--o---EXX---?-oMEEB--?-M--X-XoX-M--?o-B--o--X?X---MEE-EX??Mo---EE--oo-
-ME-X-XX-BX---B----X--XMoX?XXE-EXXoBE?EE-o-Eo---oo---E--EX?XXB-o?-E-XX-EBX-XXEoEXEMEM--E-EEEX-X--EEBXoBE-E--E?XE?-M?XoXXEX-B?Eo-XB----EE-BX-XE?X-BX?XEEEXo-XX-ooE-MXB-EE-XXB--BX--BXoBXX---oE-EMX--EEBo-
--E?X?-E---B-XXoEMB?oEE-EEEE-Bo?oEXX-E-BB-EE---XXBM-X?X-?-oMEBE-BXXXXoE-XXEXEXEo-XXX--XEBM--E-BXXX-X-oBEX-EX--o-XEX-EoXXXEoME-MBX--BoX-BBo?X-BBXE-E--E--E-EE?EBo--B-EXX-BXBXXM-?X-XXXB?X-EoXM-MEX-o-?---
-X-?X-EBBE-?MXXoE-o--E--EXE-E-BX-X-EEXB-X--BE-oEXEoXX-E-E--XX-EX?-XXMEEX-EMo-oE-B-E-XXX-E-BXEXoX-?-BoEXXX-Xo-XEo-EX---XX--EBX?o??X-?--XE--EEE-X-XoXEE-?--E--M-XX--o-?B-X-X--BoXX?EE-EoEXM-XoXXX-XB---EE-
-XE-XXX--XX-Eoo-M-ME-EEo-X-X?--EXoXBEEBXoE-o-o-EXE-EXoE-oXXB-ooMXBX-BXX-BMEEEo-BEBXE--EXEX--EME-XooMo?-?E-EoooEB-BXEEooEBB--BBoE-Eo-B---XX?-EMEXEE-Eo-XBo-BoE??-EM-BEX-oo--EMBXoXXEXXXB---BBEXoMXE--XEM-
-E-EXoB-XBE--BEEEXEEX----E--E--X-Xo-XoB-EE-XX-XEXBX-X--o-EE-oEEX--o-o--?-EMEE-X-E-EEo-M-o-BMX-EXoXXE-BXBBXXB-oB?-?BXBBX--B-XXBXEXo---EBoXEEEX-Eo-EXX-EEE-oXBBEB-BXE-XE-X-oX?Bo-o?-oX-X-XB-B?o--XE-EXE-?v
-XX-oEE-BoEoXo----EEX-o-EoXE?-E-XE-EXXXXo-MoX-BoMBEBXE-o---oXX?XXME-XMo-B-o---BEoE?XXE-BEE-E--oXoXBoo---oEoM?MXEBE-XEX-?EE--oo-MXo-X-EM-EEXB-?E--oXo-MoX--o-E?--XXXX----E?XEMX?EoE?-X--MEB-X-o-BE-XEE-Ef
-?-EM?EE--BEoBEoEX-Eo--EM-?XXE?-oo-BEM--oEoE?o?-BBEX--Eo-E-XB--E-Mo-oB-oEX--oMBoX-BEoE-X--MB-BX-EEX?BEB-o-XE-XXEBX-E???X---?XBoXXoXM-XXo-MM-X-ooB-?EEo-EBEEMEE-EEXEEME-oM--EMo--X?X-BMBMXEo-B?B--E-oXB-f
-B-EX-Eo--?oB-EEEEE-oBE?----E?-oE-XBB-----Eo-BEX?oXX-XBXEE-oE------E-??E-M-ooEXBBXX-BEXX-B?XBoE---MEooXBE?oXEBM-B--B---BXoXBX--X?M-E-X--oXE-oE-Bo-XX--XE??Xo-X-EXXE-EX-EXB?o-XXoXoX--XEEEEBo-EX-EXE----f
-EMXXM-E-E-E--?-EXoBEXEXXXo?--MMMoM-BEB--XXo-ooXX--?X?EBEoBXo-oBE-oEX?-X-Xo-EX--EXEX-XXE-E?o---MoE-EEE-X-BBB----oMoE---B--o-EoE-BBX-o??E-BEXoBEMo?X--B-E-ooX?X---EXEX?X-BEXXME-X-EEMMoBE-ooM-EXX-oE-E--f
-?-X-XoE-X--MXBX-XX-??--MEXEXXEEX-BEE-BXEoEM-EoX---EX-B-X-E?XEEo-EEoBoXEB-?E-EoE--oBoE---X----EXX--XMEEB---BMoXX-X---X-XE---?oBXE-o-?XEM-X?o--EEE-X-XEBEo-EB?MXE-Xo-XM-o?-B-MX-E-XEXEBoEX-E-X---Eo--XXXf
-?EXBB-B--EB-MXXXo--oMEE-?XM?--o-EMX?EXBXXEMo?-X-EEX-XE--?EXBMEEoMXEo-X-BE-EX?XBXXXEX-M-XXE-X--XEXEM??B-X--?-oEo-X---EoEoB-X----?E--XE-XBEBXE-EMXX-BXX-E-E-Bo-M-M--EX--XEo--MEoXEoE-EEXE?E---XMB---E-Bof
mX?E--B-EE-oBoXEBEXX-?X--EoE?EBBEMXB-?-oBEE-oB-B--X?XoEEX---E--BEX-B?XM-B?--EMBo--MEXXB-EXBoBBE--E?X-E?XMXB-XooEB-EXoEE?EoEBEXBX----EEXBXBMXE-B--MM-MX-M-X-X-E?-oXoEE--EMEB?oEBEE?B-XXBE-B--oMEXEE?-EEoX
X-EBXXBME-EXB-XXEM-o---EoBXXEBXBo---Eo?oXB--E-X----BoEXB-XEE--X-MEXX-BEX-Xoo-o?-EBooXXM?oEEBEM-oEE-X---X-XoX-Xo-MEBXME--o--?--XE-BEB-XXEE--EXXXXE-EoEMME?XXX?o?--BBoBE-X--B-E?EE--EX-EMEX-X-EX--B--MEB-X
