----oB-oM-----M--M-----X----E-B-------------XB--o----XoM-------o-E-?----M------o----X-B-?B--BE-M------------E----M----X----------XE?o-M---X---?--------Xo--?-?--X-MM--X--B--?----?---B------o--EE--XE-?-
----B-?E---o---E----M-----X----X---------MM---oo--B----E----X-X------------Bo-M--X---B------XE---EBo-o-----------------------------oB-----B-X-----o------M------E----B?oB-o------?B---E--o-----BB-X-M---
----------------?----B-E-MB-X------E---M-Bo-EMXX-B----?-M-----E--------?-o--B--E?----Xo--?--------o-----MoM-------M--------MX--------B-X-----o----M--B-?--------Eo--MBo-EEX-----o--M-----?--B--MX-------
-B---o--------X?-------------o-M---B--?EoE---Bo----X-----E----BBB--M---B-------Eo---ooE--------------BME--?--------X----E----o-??-------MXXM-----------?---?--B-X-o---E----?----XMo-E----X----M--E------
-M-BME--B--X-------E-E-------------MM--X-M-----?--B---X-----?M----------?--?-M-----o-M------o--E----X-E-------BM--E----oM-o-----o--B-?---------MB---X------B-X-------o-----E---oE-X-B--E------?-?E--Eo--
--EoB-B----BE-oE----oX------EB---E-E------------BMX-EE---B--B-X-------MB---o-o--?----------X-o-E---B---M-XM---o-o----?--E---B----------B--------??-------XX----------?----X--------X---o--E------XM--B--
-Bo-BB--o-----B-M--o?-o-------------M-------EE--o---E--o--o---EEXB-?o-M-----X-?---------X------E-B?-?o----o-----BX-------X---M-o-E------------M--M---B--------B------?-B----------?-X----B?-B-X----?----
--?-o???-?----X-BX-?------?B-M-o----X-B----X---o-oM--E--BMB--M-X---EEXB--B--o----M-Eo---o-?-----MX-------------o-X---B----M------B-----M--------?M-B--oE---MXM-X-----------o-?----X--Xo--M----?-------ov
-?M-oM----M-------B-?-E-----------MX------E-B--?MoB--X-oE-----B--E-B----B---BM-X---M-X-o-----?--X------------oE----E---o-o--------B-oXB-----X--Bo---X?Xo-BMMBX--B---o-E-B-BM----?X??------EX------B--?-f
-oB-M----?----o-EB---EoE---M---B--M--M-X-M----M?o-----?X-?-----------E-X-?------Mo---?XM--X----Moo---X--o---MB---M------X----?--------B------?---Eo--M--B----M--M-M----M-----M--B----B-B-E------BM---o-f
------ME--?-X-----BE--o------?-----------M-M-E---------------X?------B-?--?-------B-XM-E----E?-----?-B-XoB-----------------BE-BMMo----?----------E------E-E---E?----?-EM-BXo-B---?------Mo--?-B-X---MM-f
---Eo--?---BB-o------B------EM---------M----XE---EX-X----E-----------o---E------o--X?--------ME-E-BX-M-o---o--X-E-B-?-BE-?-EX--M---B?-X---?--X-X?-----XE----E-M----M------?-----------B-------B----XB--f
---o----o-B--?---B?-oX--?B-----X---------o?-B-o?E---EM------o---------M-oB--------MB-o--XE--?--X-XE---B---?o---o---o-X-E------X--B-------E---------------E--B--XM--XX--o--MoM-M-ME?BB---X-?----oB--E---f
-oB-M-E----XXB-X-?--E--E--BE----E--MX----E------EE---X-------EM----B---------EX------o--ooE-X--M--?----X-E--EX-XM---Xo-E--Bo------------o-B----MM--------BEo---o------E-------BX-?EMME-X----?--X-----??f
m---Mo------oX---------E--T--------X-BT-----?----o--B-B--E--ET---?----o--o--??E-X----B----X----------MM--ET-----------------M-TB--------oM---X----?-X---o----E--------EX?X-------?-XT--T?-----------B?-X
XXXBXXXX?XXXXXXXXXXBXoEXXX|MXXXXXXBEXo|XXEXXXXXXXX??BXXXXEXBX|X?MXXXXoXEXXXXXXXXXXXXXXXXoXXXXXXXXXMXXXXXXB|MoXXXXXXXXXXXXXX?XX|XXXXooEo?XXXXXXMXXXBX?EXXXXXoXXXXEXX?XXXXXEXXXXXXXXXX|XX|XXXXXXEXXXXMXBMX
