-------EM-----?E-EM-oEoo----E-XEXo----B-Mo--B--B-E?X-oEB-?-?--------oo--X--o-MMBBB-XXXoB--?-XXo---EB-----o?-X-o-?--B?-?-BMB-MoB--X---XE?EM-o-B-X--B-Eo-XEE--?-B--E-XEoX?----E-M--o---?-X----XEo----B-?o-
-B-o-MEo-B---oBo----o---BX---X-X--X---X-XEoX-?--oE--M---XEEoX---oX--XBEE----X---oo?-o-M--XoXBBMX----E--X?oM----EMo--XX-X-?-?EX---XBB---M--?o-M-BB-EX--?---o-B-B----B----X-EM-MB-?------BXM---oXME----BE-
-o-X--X?X?E-M??------EBo----M-----X?M-X-M?-E---?X--BB--X-o-EXB?o-M--X?-M-EB-oEEBX-E-E--o-Eo-BX-BE-BBX-E-??---EX-MB--E----?-X-o-M-----X-Xo?-?X-B--EoBMX-X-??BoMo--EB-XX----M-B?-E-B--E-o-B---BBB-o---X---
-BX--o-o-?-MBEXE---B-o----EB-E-E-----o-Xo-M--E--o-?B-oEX-----E-?B-B--EXX---?E-B---X-?-XoE?X-o--E------EBX-XB--X?---XoEXE-?------M-XE---B--?XX---BE-?-BB-E----XB-X-Mo-E?-EX-o--?-M-----?BMX-o----X--MXE?-
-?oB?--B-MBo-?---XXoEEoXE-XM---o?-??--M-E?B--E?-M-M-E-o-BoX-B-E-EoX-M-E-X---X-X-E-o?-o----E----B-X-oB---o--BM--oo-B---BXo------ooE---E--oo--?----?-B---oXB-X----o-Xo---MX--o-MX-X---oE?-X-X-Xo--XBB-B-?-
-B--Xo-EME--BB---X---BE-B--BoM---Eo-?-----E?-EEEXE--BB-X-Xo---XB-?EXE---X-X-X----?-E-E----EX?----oE-oBEBoXEX---EBoB-M--XoXE-B---XX-------EoX--?-oB----------o-oB--o--E---B-B--oM-B----XB--BEo--------E--
----EEBEoX---oE-X-oB--EX-oMB-E--oo?--Xo-X---E-o--M-BEBXX-X-X-o-----E--B-o?o--X---X-----oMo-MM-B--o-EX---M-oX----E----B?-XEo-----B---XX---oEMMBoXBEoEMBEM-o-X---BB------o-XoEX--Xo---?MEB-BX---B-X----M--
---B---X-X--oEoEX--E?-X-E---E--XM---X--MMM-EBEoBXX-----BBB-X-XE---BB-X-X-BB--XEX?----oo---?X--X--BM--o-o?M-EE----E-o---XBX----X-o-B-B-o-BEBE-?-B-B--o-------BMBo-B-X---BE-M-oB?--oB--oBMBB--M-oEB--B-Xov
---E-X--ME-?E-oEX-B-E--o-?-oX---MXEoE--E--B?-----B-?-BXXEBBXE-oBo-oX-BX?oE-XMM---BM--E-M-BM--??-X-XXE----ooB-----XMBX--?--EMXB-MBBBX-?-XBBXE-o?B---o---XEXoE---oo-----M------?oXBB?----oM?-?--XM--?EX-Mf
-E--Xo?E-M--X--XE----B--MM-X?o-E--E-EBB--BoEBEB--EM-X-??MB-X?-?-X?BoBE-BX----E-BB-M--?-Eo-?o-ooo-X-----o---X---BoX-M--BBB?-XMB-E---?MME-o--oXX--BoB-XoEM--E--BB---B-B----?o--B-E-B---B?o?-E--XoB--B-EX-f
-X----X-B-X-oM----EXB------X----BX---X---BXXX-B-B-B-BX---EB------X-Mo-----??B-oBEBE-o-B--oX?-o--B--X--M----MEX----o-M--?E-oX-E---o-o-oEBEBBMMXM?E-B----BEB--BM-MooXBE-X-oo--B-E-?-B-o---EM---B-o----EE-f
--E-o-EX-?Bo--M-?EBX-X-o--E-XoEE-----XBXEX-?-E---?--XB-E----oX-X-EM-----M--EXX-o------XoB-X?-o------EE-oB--o-o-oE-E-o---B--EE--o--BBMX---E-ooBXo-B---ooB-MM---EB-X--E----B-------EEMoBo-X-E--X---------f
-E-oX--E-XB-XMM-oBo--B-B--B--Bo-EBX-oM-EXMXMMBoo---X?----M-----MXB-XE---BBE--E?--EE-o----?-o-?--?-E---E?--EB-?------BM--BM-o-EoEX-oB-E-B--o?-XM----B-X---XE-XX---XB-BM-Xo-oE--oX-?--MB-o-EBE-?-M--X-E-Mf
-E?E?-E----BB-B-?BB-o--?--XX-B--MB---XX-X---M-B---o--B--------X-BM-M-EEEBoo-oX-o-MMBE--M-EBo--oEX-XM-o-------BEo-EXBX-X-E-Eo---X--oM-------XB-E--X?XEo----B-EoEo-EEo---o-??--B---BXo-X--E-o-oEo----E-BMf
m---EMX?B---MME--BX--?-M-EX-MBo----BEXX--BX-?--E-o--X--?-Mo-?B---EoX---X--?--o?X-X--EBX----B--XE---BX-B-E-oE-E-----oM-o-X--X-o--BXoB?E--B-?--XBB--X-E---BB--E-XB-M--EM-oM-----B-o--MoB----BB-X-B-XMB-?-X
XX-M-?XE---X-EX--M-?---?EM------o--?o---B-?o-o--BXBE---EX?XXXM--B--E-?-o-MBX-M-?---E-----BM---MEoB---XBo-XE-BE--?B-?-?--B-B-Mo-----E-X-B-BX-B-E---oE--o--oE-X------M-Bo-X-M-oM---X?-XEX?E-X---XX--B--B-X
