----oX-oX-o-o--M-X--oX-M---EM--X-------MX---------------------M----X------------X--M---MBX-X-?----BXX----X-?--?-MXE---X----X-?B-X-oBXX---E---------M?M--X--M-X----E--X--XBM------B-B---EM---?--o--E-----
--X-M??E-X-o---E-----XE-X-X----E----E---?--B---M-XXM----E-X-XMX-X--X--B------?-?----X-?---XBMM--XMo-o--X-------XE----X--X-oMM-X--------M--M-?-----X----?Bo--o-B-oX---B---B-----X---MBX--BBEBo-----M--M?-
-----EB---XXM---oX------o--EEB------X-Xo------------XXEo---MBo--XX-Bo--?-?-------?---B----o-M----E-?---EX-?-EX-o--XX-------X-----E-EB-?----X?----X--E-?-----Mo-X-BE--o---E----X------E--B------M---MX-?-
----X--?------XX?-M---o----E---Mo-X-B--E---EEX--?--?-E--X-B--E-XMoo--EMo-M-o----MX-MME-----XXo--B---oEX?XMX----E-oB-o-B-M-M-X--X-?BoX--X--oE--E-BBX-o-XE-?E----M?B-?o-?--oM--?-Xo--EMEB--M--M-Xo--------
---X-----M??X---EE---E-B--M-XEB--oo?--E-o--B-X-X--B-E---?--X--?--oo----?-X?--o-XM-----E-----o--B-E-MEX?----XB-?B------o---o-----E---?X---E--X--------------B--X-----E---EM-XB------?---MXEo-M--XE?----X-
-------------X----XX-----?--o----oX-BXE-o--B-----X-?--MX-X---M-o--------------BE-----X-B---Mo?-----B----------X--M??-E-oXoM--?---M--B-B----B---?-oo------M----?-X---X-???--M--E---?--BBX-X-o-B-B-?---M--
-EX---?--X--?---ME-M-B----------X-X--M--X-B-?--?-----------o----XE----o-XEoE-X?M-?---X--E-X------EM--BX------?B----X---M-----E-------X------EB-XX-?---M-----X---B?X-E------------X---X-oM--MX---X-M-?-B-
-----EX---M-X---MXB--B-----?----?-----------?BB-MM-X--E----B----B------o---o---M---oX--B---X---?---------oX--oE--X-------X-----E-M-------------o-X--X----?XE-X-------X----o--XB--o---X--EB--X---?X?-EX-v
-o-----B?-XB-----B-----EEX-B?-?-M--B-----?o--EXX-B-------M---X-----M--X--X-------E----?--?-X-----M-----------E--------?------XXX----o-EMooM-X-B-B---BM------X--E------X-----?----?XB-B-?--M------------f
----M---BoMM------X-------o-----X-M----B-?--M--X--??X?-?EX-o-o?EB------B?----o----MX------o-----oB--M--B-B----X-EX--Eo--o----E---X--M--BX-B-M--X-oEX-----X-E---X-?--EB-M-o--B--M--B--E?-----EXo----?---f
-B---X?o-XE--X--XXXM--o-----X--X--E-X?M--E----B--oo--X-o?---o-------B-oo-?-XX-o-------X-o?o---o-ME---X---o-X--EE-----X?XX----X-X---?BXME--E--X-M---BX-----XX?----XX-?--o--B-B-o---oE------XM----------Ef
-B-X--X--X------B--M---o-----E---?-?E-o--X-----------E----BB-o---o-X-XX---o--X--B-o----?-----X-X-X----o?BXEo-o?--?--M---------?--X?-----E-X-B--E-?oE----X----E?B?---------EXoEB----E--o-X----BX----o-X-f
--X-B--?---B---?--?--XM?EE---M-EX--?---o---X----M?B--E-o-------o-----B-?-----o---XXX-X--?X--XXE---B-E--Bo-Eo-X?B--?oEB-------MBX--?XB-----X-----M---BB--?-----EoXoB--X---E-B---?--X?-B-MBB---XM-?------f
---E--MX-X-XX?-MXXBM-oM?-------?---E--X----E--BE-o-X--?oX-X---B--EX-BX------X-E?-?---------X----oo-XMoXE-B-------MB-B-E--o----M--X-----E--X----X-M-Moo--M--X-----MX---Mo---?-BEE-----o-EX------E-M----Ef
m-------B----X---?--X-?--o-X-?--------o--o--------B----?-M-EX----X---XB-----o--E---?----E--E---M----X----X-?--?o-??------XEXB---------------X--oEo--?B----MXX----B------MBB-B-?--?---XE----M-oE--E-o-M-X
X-Bo----oX-----M--o--E---XB-B-X--X-Xoo-XB--XXo?-E?-M---MBM-B--M--B--M-B--B--??M-?E-----oXX--o-B-B?--E-X----X-----X-X--o-Mo-----E??-X--X--------X-BXM------BM-X----E?--M-o---?-M---X--X----EEB---oE---o-X
