TE--------X--o--------------X-X----o--------------ooE-E------------X------------E-------o----------E--o----------XX----X---E----o-------o-----------------------E----E-o--oXE-----------E--------------X
----Eo----------------------oX--X---------------------o----E----X---------------oX---X------X-----------------------------oX--X-----E--X--------o-o------------------------E-------X-------------------B
Bo----o--EX-------------E------------------o-----------X--------X------------------o-o-------E-----------X-o---------------o-----o-----E-X-X--------X----XE---X--------------E----X---------E------E-o-X
X--E---E-------E------E--E--E-------o------o------E--------------------------Xo--E------------E------E------------E-----------------o---------------------X---------o-X--E--E--------o---E---------XX--o
o---X-o--X-Xo-----------oE---------EX--------------X------------------------------------EE--------E---X----X---------------X-----E-o---X------------X----------E----------o----------E----------Eo-----?
?-X--X------EE-X-------------o-------X----X-------------------X--E---o--------------------EE----E-------o--------E-----X-----------Eo----------X----o------E-o--------X-----------o-------o-----E----o-|
T--E--X--E----o-X----EXo-----------------------------o--E--oo-------o------Eo----Xo-------E-X-------------o-----E---o--o--E-----o-----E----------E----X--o--o---X-------E-----E---X----o--------XX------
E--E-------o--------------XE-----------------E-E------E---E-------------EE---X--------X------X--X-----XX--E-----X--X-o----------X---------------------o---X--EE----X---o--E-----------------X-----X----v
?-E-----X----X-B-----EX--M-B-------XB-E----?-------M------?--M-------B-------X------EX---B------o-o----B-------?X------B----X-M---?--X---oX---B----------B?------X----M--M----M-------?-o--?-B--o------?
X-??-BX?------B------?-----X--------M---ME-E----M?-X-E--oMX?---o-BE--B--?--B--X------------?MM-----EE----ME?-E--XB-M-?EX----B?-------M-M------?--o-------B-EX-------o-oB--------MM----o----MXBM-----?---
X------------B---Bo-B----BB?----------------M---B------M--X----E--E----M---ME--o??-B-E----E-M-----??---E-M-------E?-E--BB-?---M--E---M?o------B---X--Xo----Mo-----X-----M-----E---------E-----B--B?E--?o
o-E--o--M--------?B---?--------E-----------------o-BM--?-------?---?M----X-?-----oEEBoE--?-----------o-o?------X--ME-E----EE-o----------E-------?-o-EM-X---BM-XM---X-?-X-X-Mo---B---B--------M-??o--E-X|
T--o---E---MM-B--------MBX-------EE?-------MB----o----B?---o--X--?-o--XM-----oM--MX-EoE------oX-----?--EoM-BoB--BM-----?---o---?Xo-------B-M----Xo------MoM-B---------o?BoE----BX------o--BX-------EE-XT
--MM?oX-----B---B--MX?MMXM-?------B------?------------?E?M--M-?-o-----?---o--E--oo--oo-------X-B---M--XB-oX--?E--------B--o-B-------B--o---M-E--?------?-o-----o-M---B----B----B-B----?-E---?---o?MoEBo|
mo---?------?-----o-M-o-M-M---?--EB----BB---o-??E---Xo-----------M---X--------X----E--B--X--?o??--X-B-----E-Mo----------M------?M----?o-E------?--Xo-X-X----------M--B------------------------------M--?
XMoXXXXBXXXX?BXXXXXXXMXXXXXXXXXXXXXXXXXXXE?XXXXXXXXXXBXXXXXoXXXXXXMXXXXXEXMXXXXXoXEXXXXXXEXMXXXXBXXBXXX?XXXXXBoX?XBXXEXXMMXBEXXXXX?XBXXXXXXBXXoMXoXo?XXXXXXXMEXXoMXoXXoXXEXXXXXX?XXoXXEBXXoMXXXXXXXXXXBX
