-o-----EX---oo---E-------M------oE-B--E--?-----o?E--?-o---o-E---E---o---------E-B--Xo-E---B----BMBB------E---MM----o--BEB-----M--EXo--E-XX?-X-E---oB--------X-E-------B-------?----Bo---X--o-M-----E??--
-MBE---B-E------o------------MEo?--E---BE-?-X-M-?---------X-----M--o-B----BB----------E---B--------B-EM---?-M-X---EEM--------?XoB---o--EEE-----------?EB------XoM--o---------E--X----o--X---------B---E-
----B-M-M-?E-BX--X------EXo----?-M---E----M--E-E-BX----------E------M---?----o-Bo-XB---?-M-oB------M-E-?---XM-----------------XM--X-B------X---o-?-XB---o----XB-o-----X--B--XE-Eo---o-M-----M-oo--MB----
---------?--?E----MB---------M-E---------MB---M----E-?---EX--B--?---M----B-X-----E---X-M----E----------EoE-M-------?B------?---XXM-?-oX--MB---------M-B-E----------oo--X-?X----?M------?-B--------------
---EB-------------o-------E--o--E-X--X?--EX-----M---XEM------?-X-----o-------X---E--M--E--E---E------E---------E--?-E----X---EB-B----E----?---------oE---X-----X--MXM-M---M--------B---Eoo--ME-EBE------
------M--?X--------BEM--B--M?-o-------XB--MEMB----M----o-E-B----------X--MBE--?---o--E------B--o---B-o----M-o--B-----?------BX----B-oE--?-EM--?-E?-X---o?-o--M---oE--o-BoE-----------E----E-------------
----B---M---ooo---------X--------------X---?-M--B-XM--X-----E--o-o----M--?--?oB--B----BM--X---------B---E-B-?--B-EB--------E-E-------M-ME-------?---X------------------X-X----o----M----BB-----EMB--XM--
--------------X---X--oB--X---E-----X-B------------XB--X------?M--EE---E--o--------M-M-M--E-------------?-E---E---X-------B----X----------M?-B------?-E---Mo?oo---?---o-?----o-X---o--E-E-o------?---MXEv
-E---B-----X------?----MB-B---B-E------B--E--E---------B---M-----M-o-B----XB-E---X-EE-------Bo------?-EB--??E?-o--X-o----o--EX-----B?--X-M-B--E-----B--E--E-E----BM-MMM------?M---o---M------X-X--E-X?-f
---XM---oM--XE-M--MM---M?--E----??------Xo-EM---Boo-?-XM-----?--E-------o-----E-o??------M---oX-----M--------?oM--?---??-?-----BB----E----XB-----------B-o----X--M-------------XX----?---M----B-------?f
----?----X-------?-XX-----?--MoXE-?o-?-B---oE-------?-----------X---o--X---o?--B--XM----B---X--E--X-M----M----E---X--?--BoM----X----E-M--?MX-X----??--------BM?-------o-------?-M-----------M?---------f
-EB-X-----B-o----XB---M-o---B-E-?M---o-X--X--?E----?--o--?------E------XBEM--?---B?---?-----EB------XBo-BM------?-o------------o--------E?XX--E---B----M-----B-E--Bo?E---X?-E-Boo----o?-?o---o---------f
--------X-X------BE--?-------?--X------X--------------XM?-----o----?-EM--EMM-X---BEM-oX---M-------E-M--EBo-BX----M?-o---B----M-X--X-E-------B-E-----X--BE-B-------E---X--?o-----M---o-E?-??M----X-B-o-Bf
----?-----oE-MB-?-BEo-E-oM-M---MM--?BE----X----X--XXE?X?-----M--E------?----oXM--MB-?B-MB-B----M---Bo-----------Eo----X-?-BB-?B-?E-----o-B-----E?-----BX----M--oB------X-M?B-------BE-----?--?---??-Xo?f
m---?-----B---M-oB-oBXo-------?--B-----------BXXM-----B---E-E------M-M-?---o---M----------?----MB--B------X--?-----B---------B-B---E------?-Xo---o-B--B-X-?---------oB-E-o---?--------X----ME---E---oo-X
XXXXXXMXXXXXXEXXXXXXXXXXXXXXXXBXXBXXXXXX??ooXXXXXEXXXXMXX?X?XXBMBEoXBMMEXXXXXXXXXXXXXXXXXXXXBXXXXXX?XXXXXXXXXXX?XXXXXXXXXXXXXoXXXXXXXXXEMEMXXXBXXXMXXEXXXoXXXXXXXoEMXXXXXBXBX?XXXXMEEXXXXEEoXoXXXXXXXXXX
