----?------EXo---MM--??--------o---M-B-----B------X----M---X--X-oE-------M-o--EB---E-X-?--------E-E--oX-----------MEX--X--B--------------E--B-------EoEMX----------X------M--------o?-----------?---B---
-E---oE--B--Mo---E-E---?-X-EEo----M---B-E-o--oE--o-?X--------?-M---E-Bo-------B----X--B-------E---B---------oB---------M---X-M-E--Eo-X-o--B----?M?-o-------Eo------B-------?B--o---B-o------X-------o---
-----BB--------B---Mo--B--M--?----------BE-BoB-------oMX---?BX-------Mo?-o--E-E---E??X--E----B----E--E-----M---X----B-------------B---M-X-?M-E--------?----E---o----XEB-?-------M--?----B--o-X-E--E--o--
--M---------?----MMB---------o-----M---?M---M-M?---XMX------?-M-----X--?---M------E-----Bo-MB-----E---o-X------o---B--Eoo-oM-?----Eo-?-----?----X----E---?--B---?o---MB-o---o--------?--X-oBX-?o-B-M----
-B---B--------o?-------X-E-?--oE--X--M-E----ooM---?o--------X--?E------E-?--B---------?----o---M-?---EXEX-XoB-E-MoX-E----?---?M-----?----B?-o---E-M-------B--?---?------B-o?-----B-B---E---?-----o------
-B-B-?BXE-----?---------X--M-----M---------oo-------BE-o-XEXo--X?E---X----MB-----o----?-------BB--------?-E--------?-EE-----M----E---Eo----B-o?--EB--X--o?-M--M------B------X?M----E-------B--oM-o-E--X-
-------M----?ooXXE-EB----M---------------BXo--?-M--------M-----?---B?-?--E---o--------o----o--o-?------------?-MX---XM-??oX--?E---o--B----------M------o-------X-o------M--B---XXMo----E-B?---?----X--M-
----E--B-X-B---B-?E-?----?--X-----?------------EMEE--?---M----o---E-----M-?-----BM-M----B----E-EE?o-----M-X?------X---ooM------------B??E-??-?---?o-X-MEE---o-E------------M-----------?--X------Xo---?v
---M------M-X--X-E-BM---E--BBo-E-----B---?B-X--------------------o--M---?B--o---BB-----oM----EE--MM---o-----Xo-----B-----E-B---X------?--X-----------------?-EE---------?X--B-?E?--B-o-?-o?--M----B---Bf
----M---MB-B-----MEEM----?--------EEB------M------?-o-------o--------oMoBB--------B---------E----EM-------o----E-----------M-oM--?---o--B?----E------B-E--M?-?-----B-o--E---M--?o---M-o----o?-o---o--M-f
---X-oBE--oo-E----o?---Mo-Xo-MXX?M----BB---BB-?--BB--------E--?----------BBM----B---?---------o--M-B--B---------B-----o-----B-B--XoMX----o-o--------B----M-?---X-o---E--X------XB?----B--o--B------E---f
-o-?-----MMX?---X-?-E-M-oo?------E----E--??E-------------------B-o?----M-X---Xo--------o--M------?--BE-M-------------XB----------X------E----?o-B--X----M----?B-----B---B-X--?-----?-?BX--M?-X-----o---f
-------Eo-?E--------oE----M-----E--?--?---o------?-Xo--------X?---E-E---B-E--E-X-----M--Bo--B--o-EM----o-oM-E-B-E-----o------X--BMB---oB-M---------------X----------X?oMB--o?-M-----?------E-?--M-X?X--f
-M-X-------o---X--M----oX-o---MEE---E-B------E---E---XB-?---------EEM--B----------MB--M----------B----------o------?--B--------M--E-o---?--BB--------B----X----------------?---E--?-----B-----E-B-o-M-Bf
mEB?o-E---B----?--X------B--M-------------M---------------M-o-MM--XB-Bo-------B-----??-XE-M----X-M-----E-X--X---BX?-o----------o-----------oM---?-?o-M---oX----EX--X?-M-E-M------?-XB--M---E----o-----EX
XXMXBXX??XXXXEXXXXMXoXoooXXM?BXXXoXXXXXXXXXXMXXBXXXXXXXEXXXXXMBXXXXXXXoXMoXXXXXXXXEoXXXXXXXXXXXXXXXXXXXXXXXoXXEooXXXXXX??XXBXXXXXXXXXXEXXBXXEXXXXXXMX?XXXo?BXXXXXXXMXXXXXXXXXXXXXBXXXXMBXXXoXMMXEMXXXXXX
