------M------M-o----------X-MX---E----?X--E-XXM?---oM---------oB----o-------X---?----B-X-----oMX--B----M-B-X-B-o--E--X-?--?B------Xo---Xo-X---E--X--?------X--X-------oX-X----oMX-?---X-B---X-X---oXoX--
-----ooX-----B--M---X-X--oE--B---------B--XMX----B--XE--o--B---EX---XoM------??BXB-------------B---X-X?E?M-EE--X-----MX-XE-E-------?B--X---?----?--?o----XBXo-X-o----E----E-X-X---B?---------o----MX-BX-
-BMX---o----------XB---?oE--E---B-?---X-?---X-M--------X--BB-E---E--E-------o-?E-?----X-E--?o?oM-X---o-X----B?--X----X-X----M-XX-XBMEB---X-E-------o--MX---M-----?---X-X-M??----oo--XB-----o-MX??----X--
-EMX-X-----oXo-M?XX--------EEM--X-----?----X-?X--EX---M--------BX--XMB---XX-----?--XMM-EX--XB-------X---XX--X-?X--?--B--------E-?oEXX----oE-----M----B-----XMM---------M?-oM--X---X-E--o-XX----E----X---
--B?--?-----ME----E---EM--M-----E?B---------o--oX??--X-MX---XMMM?------MM----E?--X-X-M---B--?---oX-MX--E?-X----E--XM----X--------?X-M---o----XX-----BB---E-------M--BM--M---------X--X--E-X--------MXXM-
------EX-X-ME-------o--E---o--X-M---oM-BE-XM-E-ooX--?-X----M---B---XX-?------MMXX------------------X----X--E--o-XB---X--BXMo---?---?B----------E----EX--------o-XB----o--E--o---X----X--------X--o-??---
--XMoo-o?-E---------E--?-B-X---Xo-XXE----?-X-X-E-X--B-E-------X-------E--X-oo--B--X--E-----BB--X--B---B?--E--X--X-?-B-?X----BM---X---------------X-XBX-M--X---o-B-B-X---------X-B------oX----E------oM--
-E----BoE-----B-?B----X-ME-X---?--?----?X-E-?---------M?---?--M----M----o?E-E-B--B------X-XX---X----MX-X?E-----X---E------E--------X----M-------X-X-----B---M-M-B-o-B-EX--E-----B--XX--?---BB-EBXX-?---v
--??oo?X--X---------BB----E-o-?-Xoo-E---X-------------E-MX-XX--E----?-BX?E----o--oM------?--X-?X---?-?-o-o-EB-oo--------XMX-o--XX----XB-B--?---X--o-----X-X------X-M-----B?----??----o---B--B-EX--X?XoXf
-X-M----M-----BE--B-X--oBB-BE-oXX---B----X-?oo-BXX----?---X-------M----?--Eo--M---o---E--oXE----?--B--oBooXoM-BX?X---B----o-M--X-----E--X-----?-X-M--X-X?----oo-EX-E-B-BM-X--X-M---??-BX-------?-BBX-Mof
-M--M--XBMBE---M------X-----E-X---XM-B-EB-----------XB----X--oB-----E--XMo---XB--Bo--EX----XB----??-----EMB---?--X--EBM-X----E--M--oX---X-E-----BXM----B-?-M--M--?-?XE--X?------MXoo-X-B--B---M--oXX-?Xf
-XM------?-X---X-X-----XX-oX---B----?--------B-B--oXB--M-B-X------MX?--Xo-----X---M-M----?--?Boo----E----?--B----oBM-X----M-M---------X?B??X-oE---B----------------B--o-B--?-o-----------?-?X-MEE-----of
-----B------X--B--E-----?Xo-oX-Xo----E----??--o?-X-B----B--M-?o-------E---X-E-?---B---XBEM-X----B---o-E-o-------------X-MBX------XoX-X-----------X-------MB-B-M-XM--EX---X--?BM?X-o-?---?-E-------E--BEf
-?M-X-o-XX--E?-X--MBX----X-?--o---X--------B-B?Bo--E-M--M---B---X--B--B-M--B-B----B--------B-Mo---o-oBX---B-o-X-----?---B?-M-?EB-X----MB-------M-o?------X-XE-BEE--X---X-B--B---?--E-?--??--X-BEE-X---Mf
m---M--B?--?--?-X-MBM-o-X--MMMM--------?---B?----E-B---------X-X--E---B--------M?XX-------X-oB----?----BX-X--B--M?E--o-MMX-X-------o--B----o----oEMXBME-----E-Xo?------M-?-E--X-X--B------B--M-B?M?---EX
X----------M-----B-XM-o----EXo?Bo--E--X---o-o-B--X-----EB-MB?-?Xo-------B-?-B--BMBo-?----XE--B--o---EEB--XX--EX-o-M-----XX--oX---o----?---E-------X-o----?--X-?-X-----X-X-E--------o--X--XEB?X--EB?XE--X
