-----M-X---E----?----X-B--?-----o---Mo--E---X-X--?X--M-E---EB-X-M------E-MME---BM----?X----?---B---M-B-------oX-X---?--------B?-M----E-o-------------------------M-----MoB--o-----B--B-M-E--E---EM-E--B-
--M-----?----E-o-------M-B?------X----X-o--?-?-E--o-----B-------o--------------------X----oo-Bo-?--B-B-M--X-------B------M--E---M-oE-----------E-?--M--?---o------B---E---------M--E------X---B--E--?-E-
------Bo-----??----?------?-?-?-E-M--o?-X--B--?-------E----o--------B-EB--X-------?-M-----BX-X---M-----EB-X--?--ooBM---------?-X-----XE?-o-?-----B-----B---XB-----B--X----XE--B----------B---M--M--BE-?-
------E-------?E---o---BE?E-----?---EB-----E?-M?o--M--o-?-??B--MX?--o----M--------BE---B-------------M--E--?-----------M---?-----Eo-M----------?----B----M--?oXB-E--E--M-X--------------M-X-----M---M---
----?-EXE------E-EXX-------X---o------E-?----X-E-E-B--X----E?-B--X--?----B--M--BMME---o--X----E--XM------XM--------?-?E---?-XXB---?---M--------B-B--B-----------M-o-----------E-oE-B----XBX-E------X--X-
-----oo-o--E--E---BX----o--X-?---E-------X-----B--E-E----X-B----oE-M---X-X-----oE-X--?-M-----B?-o---E-----o-------E--E-E--BMX--------X---o--M------B----?---?XM---X---B--------o-------o---?--?---M-X---
-EB-----B?--?--o----E--E-?--B---EX-------------X---E?--o-o-------X-o-B--XE--------o---E---?-----------o----M-X----M?o--M-----E-?o-------X------BM------o--------EE---XX-M-EE-Bo--X--EB---?---EE-o--?X---
--BX--o?MXB-Bo----B--E--E-X-o-----oo--oM----------X-M?-------o---Eo?--?X--B---o-------------------o--?o-----o--EBo-?--E--?-------o----M----------M-M-?--M-E---?---?--M------B-----B-------?---BM--?-?--v
-X------X--B-------B--MB--------o-?-X-M-o--?--M---------o-M--B?-----E-E--Bo--o---------X-E--BM------Bo----X--o-B---?--?--X?X----oo----E-M-----E-------M-E------M----?-------E-----M--?-X-?-E-?--------Bf
-E?o----------E-----MM----E-X--------M------?-oo--oE-X-----------?--o---E------------B------B?-------------M---XB-------------X---E--o-?---B--o-----XoXXE-X--M---M-o-X------B----BM-X-----X---M---M-o--f
-----------o?M----M-XM---M-------X-X-----o-BE--?MEB---X--o-?-M--M----------EX-----X----E---M---o--------B--o---oMB?E-M----E-XX---------X-----XX---------------E-M--?---?-------M-XEE----?------------X-f
----B------M-M---E--M---MM--Mo-oEB----?B----oMo-E--o------?---E--BX-M-EE--------------MX--?--E-E-------?M?X-ME-?o-MM---BB----M-----EMME-------E--XM------------o--MoEEM--X-o---?--M------o-E--B--XM----f
-E-?--X--ME--E?--?------o----X-oX-oM----E-?-?-------X---X-E?-E-X----------o-X---M-----M----------oB---??----B--------X--E-------EMB-?---?-------MB-B-E-----E------------E-o----X-?o----------?---E--X--f
-X---?-----B---?---XM-B-M?----M-?E-X-M---Bo--ME-o-X-o-------?----E-------?------?-o?BMM--o---X---?------BB-----E-----X-oXoE-oE-EB--BE?----B---MB---M------XB---------o--XoX-B--?----?X-B-BB-B------o?o-f
m--M--M--T-----------??-?-T---T-----BT--X---XX----?---E-----E------TX??-o--------MXoM----X-B-------o-----E-B--------o----o-------o--X--B-?-?Eo------o-X-----o---------M-?-X--B-Eo-M-?-M---oM-B-E--BE??-X
XBMXX?XEX|XXXXXXXXooEXX?XX|X?X|XXXEXX|XXoB?XEX??XXoXXXXEMX?EXXoXX?X|M?XXXEXXX?XXoXXEo?XBXXXXX?oBEXoXXXXXXXXXXXEMXXXXX?X?XEXXXoXXXMoXXXXXXXBXXXXXXXXXoXXXXoXXXXXXXMXXXXXXXBXXXoXXXoBXXoXXXXXXXXXXXEXBXooX
