-X-Eo----X-EM--?M--M--X--E--o-B---X-MMo-oEXX----BB?-XB--Bo-MEM--BB?X----?o--E---E----?ME--EBX--M?o----X-E--X----E?BB-MEo-XMB-X?--BX---XXBX--E-------?E-B--M?---Eo-?oE--BM--EEX--X-?oB-o--o-oXMEo?-o-o---
--?----E--Xo-X-B-oXBoBXoBBB----XX--BB--M-XXoBE---B--oBo-B---?-XoEB-oE-B?---B--XB---EEXX--XoM--XB--?EXX-B?-X-?XXEE-----?M--oEB--oo-XBMoM-M--E---Bo-oX---?-X--B-?-X-MMBB-o--E??-B-----BEX?X-ooEo-XBEEBoX--
-o---X-B-Bo--EoX-EM--EEo---oB-E--XBX-o-EXo-oB-Bo-MX-XX--B-BE-Xo-EM--X-B--o-MX--E-E--E-?o?-M----o-E--X-o-Bo--Xooo-BE?XE-?BBXXEB?BXEB-XMB--M-X-----o-?EM------E--B--B--EXoE-Xo--X----E---Bo?-B-?EMXXB-MEE-
--o--?MoBM----MoE---MoXB--oM-?E-Xo---XEB-?o------Bo-B----BB?-X?--oBXE--B--o--?-X-X?-o--?EBEBX?oX-o--BX-BM--XX--E-MB---E--?o-X--XE?-o?X?---B--B?------B-B-X--BB?---oXE----B--XX-----B-EBM-EEoE--oMEB--EE-
---oBE?----o-----oX--B-oBE-?XooB-XEXo--XXE--?--oX-EXB--oE--o-E-E-M-E?oXEoMEE-XEX--o-----B-?BX----o-XX?BBX------o--ooEoo-oXE--?-o---EXX-M-E-----ooB-----X--EEB-M-B-o-?oB-B-E--X---X-M-EBEMo---?--E--oE-?-
--?E--E-X-BX--o?o--M---X?-BE-oXBB-X-?Eo-B--EoEXB-X-M---?-X?-X-o-E?-X-?---?-E-E?-----XE--X?-MM?-?--B--XEE-?EEE--?B-o--X-B-E-XB-EEE--o--MB-M-----?-oXBo-XXX?B-o-EBX----E--EoBXM---------X--oXBX---B--o--B-
-?---M--------E--X-ooB--oo--?---E--?E-B?E?-o-E-?-oBX--B-X-MB-?----EoMX--E-------E----B----oM--------MB-------X--E-?ooB-BB-o-B-X-M----?-oBEM-BXEB--X----E----M--XXXoX-?BE-X-E-?XB-X-o--BEMo-B--o-o-o-B?o-
---B-B-o----BEo----M--o--EXoX-BooB--o-B-?EM--BM---X-E-E-EEoMoEB-?EXB--o-EBE---B--?-??----X?-?B-B--?-o---Mo---BB-?--B-E-?B---B---E-X-X-BM-?XooXX--BB?----M-o?o--X--o---oB--?--o-----MM-X--E-X-XBM-X?----v
---?X-?Eoo-EE-BB-EoXX--BBEB-E--XMBEBB?--?-o--EB-o-XoXEoo----M?-E----Bo-XBB-?-B---oooBoX--E-XXM-Bo--X--E--?X-M-o?---?o-?-----oB-Bo--B-oo--EX--E-Xoo---BoEo-oo--XMoEM--o---BE--E--BoM----ooo?B-MX-MM----Ef
-X--??---MXX---?-BBE--M--M-----X?--E--oB--X?B--o-B--M--E---X-EBEXo---oE-XBEE?---EMoMBXo-X-?-oXB-E---E--?oM-XX-E-Xo--E-EB---o-XX-XB----XB--E-XBEo?-E--E-E--Eo---EEE--M--Eo-EoE--XoE----oo---o--MEo---E--f
--oX?-BBEEE-B--BoX--ME-Mo---MX-XM--E--oBM?--E-B-XBB-Xo-XM----B--X--E-MoM?-o-EB-----E-B--Bo--EXM-M-oo-E-?-o----B?B-Bo--X----ooo--XBX-EEBXo---EBEB-?E---EE--EX---?-E------?oME--E-XME-??o-oBo-----o--oXo-f
---oB--?oX-E---B-B?EM---E-Eo-M?M--XXX-M--B--B-BB?--M--o----B--E-----E-?B-?---o?X--B?---EXX-----M-EBBo-------B--E-M?BXMBX--EB---B-EX---o-X---BoX-----o--E-X--oM-BoE-----B-X-----X--?--Bo-E?-----M?-X-oo-f
-X-X-?XB----M---?--M----XE-----o-o-oX---MB-B-?-B-MB-------oX-o-X-BB----EX-----E-BXB---X?B---o--Eo--E-----BB-oEB--E-o--ooooo------?--M??-oo-o---B-----X-?-o--E?-?o-?o-BEo-X?XE-E-B--?---X--Eoo-XB?MBo-?-f
--oX?EM--B-XX--B--------X-E----M-?-o----B-o-EoE-E---X---BBX-MX?M-E---EEoX-EB-----oBo-oBB-B-?-M-X-Bo---EXoB-oXX--XX----E---BBE--XE--E-BEE--X-E?---M?---X-E--------B-----EX-MXo--EM-M--EBBB-B----?ooBo---f
m--E---o--M--M--BE---BMM--M?--E--E-?XE--M?---X-B---o--o-oMMo--MX-EBXB-M--ME--EE--EMM-B---oo--X-oX-Bo?-EBXXoo---o-BoEE----E--o-X---X?ooXoX-oX--E--XX--X-EB-oEBB-EXME-XB-----MX--E-X-----BB-E--MM-ME-MEM-X
X--BXXX--E-------EBE--X--?---X---BX---B--oB-E-M?X--EB-M-B-B-E-X--oM-o--o---E-ooo-E--B?-B---?----XX-X-M--XX--B-M-----EM----XX--XB-XBXoo-Mo--?----XBBE-?BEXBE-EE--?-X--E-XE--X---BEX?EoEM--E------E-BM--EX
