--EE--oXoo?E-o-XE-EME---EBXX---?XEMM-B-X-XoBXE--X--E-BBoB-oXEE-BEBEE-E-BEXo?---E???-EEEo-EM-EE--E?X--XE-X-EB-X-XEE?EXBX--MEE-?-XB--XXXoo-BBEX--oMMX?E-?MXXooEM-EX-EXX-o--EXo-o-E--X-B---B-EX----XX--X---
-B?X-EB-??XEM-?-BoXX-X-X-X?BEoEEM-BEXXB-XEX--B-E-Mo-BMoB---MXX--X-X-XoXXEXBXo-o-EEoBB-?XX?BX--E-E-X-B-o--X-XMBXoE-EE-X-oEE-EEoo-oEoE-E-E-X-XEXE-Xo-XEMEE--XB-EE-?B-oX--oMEoE-ooXE-XMEoM-EXX-MXEXXXBX-oX-
-XX-M--EBBBEXX-E-BXEE-BE-EB--B-XM-EXXo-BE-BoXoXo-o--E-EMBEXX-XX-E-XX-?-E---XX--B-BXEBooE-EoBEXE-XEEXX-XEEX-EX--EE-X-MMoEXXX?X---XoE--XM-EB-E--EEX-XX---XXoEEXX-X-XXMoE-oX-BBoo--EBM-?XX-BX-X-E--X-XXB-M-
---o--XXXXoo?-oX-XB-?XE-EXX??-oE--XEXoXEXX---?BEoooEEMB--EE--E-XE-MXooE?E-EE-EEX--XBEXXEMX-EXX-E-B--EXE-BB?B?-E-EB--XE-oooX---XXBX-E--oXE-E-E-EBEE-XooEoEoEEXEX-X--MEXE?Eo--?-oE-X--E?-EBBEEoMXEooXX--X-
--?XEMM-oMoXXEXE--E-MXB-oB--B--XXX-MEoE-oXB-EM--oo-o?EX--E-XE-E-E--X-BMM-XX-EMX---XEo??E--oXMX-EX?E---EXE-M--oM-EEE-XooB---E-XEo-Bo-oB-X-XX-B--EB-XXX-EB--BMX?-EX-XBEXoM--XEB---o-XoM-BX-XEEX?oMXBBX-XX-
--XEE-o---XME?o-XXE-E---o-EXXEBBXoE--XBB?EMXEM-XX-XEXXEXB-XX--E-EoEEEEE---X-B---EBE----BBXXB--EXBBEX--MEX-ooM-XMBMBEo---oEE-Mo----o-X-?E-Eo-E--E--?EBoXEMX-oEo-E--o-X-EB--BEXBE-?--EE?B-X-EE-XoX-o?EX---
--EXB-E--o-E-XX--E-X?XX---EX-XXE-BXXEXXX-E-?XEB?X-X?XXEB--X-EEMX?E?-ooMM?BX-ME?--E?EoX----EoE-X?----o---XBX----?XEEEX--BoXX-B-o-XBE---MoE-EB---Boo--?--E----XEE--oXXX-M-BXX-oooE-E-Xo--?E---XX?-Bo-Bo?X-
-XB?XE-BMBXXXXEX--oXXXo-EE?-XE-E-XX?XE?oEE-X-Mo-EX-EE---EEXE---oX-X--BXM-BM-MoEX-XX--B--EBM---Eo-o-B-BEXX-X-XEMEMM-?--B-E-ooEX-EXoB?-XE-EE?X-EEoXEEX-o?XXEXoM-oE-Bo--MEEo---oEoBXB-EB---oX--X-XX-EE?E-Ev
-X-MBX-oXo-X?oMXBXE-X-E--E-EEEBB-XoE-EBE-EEEE-B?-XXMBX?XX-EBXB--B-ME-?-BXoXEEXME--E-XB--BXo-XXX--XEBX------?--XE--?EEoX-BBX-XXM-M--BEEXM?-XXoEXEX--?Eo-B--X-M-XXoXXME--BM-X-BX--E-EB-oEB-XBX--EX-o-E---f
-E-E-XMXE?EXo-XM--X-EEXEE--?--X-E-XE-E-MEEB-X--Bo----EXXoXEXBXoEB-X-EBEB??BEBXBB-----E--XEBM---EXX----EMXBoE--EoM?MX-X-B??EXXBM?-Eo?oMXXEE---oXM-?--ooBEX-BEE-XE-E-o-B--X-E-oXE-----EXE-BEEo---M---BE-Bf
--XEE-?-oM?B-EEE-M-E--Xo?-BEBBEXEo-E-XB--?Eo?XM?--XoXXEo-X?-?BBB--XXE---XoE-X--Eo--?EB-EEMo--XXB--EEEX?XE?E?oXE?XXXoo-EM--BBB?---BoM-XXXEE-XE--XEBXBX-X-ooE--?B--E-X?----XXMXE?EEX-?XXoXo-EX-EEBBX-EXEEf
-E--E-M-EXXEXXE-Xo-E-?Eo-ooo?X-oMEo-EBXEX-E--B-E-XEBEXBBEEMBXEXXo-EBEE--XM?X-EX---XX-EXBM-E-X-oEE---BX-X?MXX--X-o-oo-o-X--XEBEo-?XoXB-BEEB-oX-X-XE--o-oB-MoB--B?EEEoX-BE---B-ooBEEEEX-BEEM-X-o-EoB--E--f
-?-?-o-oBXooooB?o?X-?X-EEEEME-E---oBMM?-BXXXEEEEB-EE-EXXXXEEX-?Eo--EX-Eo-oB-X-EMXEE--X--E?X-o-B-EB--Xo-XBE-BBE-B-XEBE??EE-X-XooEEM-oE-Mo-BXB--EE-B?EXoX-XXXE--BEX-E-BBBB---EB-XXE-XEBXXBoBXEE---E-MoXBXf
-Eo-E?E?XB--XB-BB-MXX-MX--E-EBo-BXE-MX-XX---BX-?B--ooX-ooE-EoEXBXEE---EXE?X-oEBE-XBo-EEM-X-MEB-M-BX--XEEXB-XX--MX-EEXEoXBBXEB-XEEXMXE--XX-XXo--E--X-X-MX---BM-o???XoXEE?----XXoo-M??-EE-E-EM-XXMX-E-X--f
mXBBEoXXEMoXX-BBXXEX---ooXXM--EXXXEBoEXE-oE---EEBB-E--?E?-X--XMoE-BEEX-?EoEEEE?-EXo-BE-M-EoEEEXXX-BXE-X--oEMEBo--E--XXX--XE--BX-E-EX?--X-E-oX-E-oXo-BXXEXXo--EEBB--EB?B---EX-EBoMBXXXX-o?XE-X-EX--XXMX-X
XMBXXXXMoE-BM----?M-EEMXXEo-E?E?EXB-EE-?X?E-E-oEB--XX-E-?E--E-E-BX-X-EE---oB?oBEoo?Eo--Bo-oMX-XE-oEoB---X-XBX-X-?Eo-X-BoEEE-B?ME--oXXX-B-EE?X----X-Xo--EXE-XE--XoB---oB-EMBXEBEXEXXEB?-oEE-MXXB--BE-XB-X
