-XXMBEE-BX-X-EXE?--X-XE--B-X-oE-XB-oX---oB-E-EBoo-o-EBBXoXB-E-oB?B-M?M-B----?oXX-X-oXBE?BBMB?-EEB-EE--?XEX-EoXXB--oX--XXXEXoE--X-XX--oEooXEo-XEBE-X-?EEXX--EoMEEB-XEoXM--E-EoEoXMX--E-X--ME-o?o-BEE---?-
-BEBBXXXEXEoXBEX-M-?X?o-B--oXMB-E-BXBEB-E-EXEEE---EE-XX-X-o-EEE-X-XX-EXEXB-EB-BEoBBEEMoEEX-XBXBo-EEoXE-E-?EoEoBEBEXXoB--?--BXEoE---EEBXE?EEEBXE?-XB---EoX?Xo-oMX-XXo-----oEE-E--EEX--M-X----EXXXXXEoXXX-
---MMEE---BEXXo-BE-Bo---oo-B-XX-EXXMXooEXXoXoBXEoX-E-oo---Xo-XoE-BEBX---?XXEE-oXX--B-X-XXB-EB-o--oEXooBX-EXXEoXBEEBEXoooXXMo--EE-?X-XX---M?--EoXo--XEXMXMX---XBB--EX-X----oE?oEEo-X---o-ME-BMEB-Xo--M-E-
-EX---X-EEX--BoBEE-E-X-EEEXEE-E-XB---BBB-X--B-EXo-XX?XX-XM-BEEE-E-E-oXXEM--EX-BXXoE?-oEoXX?E?oXXB--oEBX--XE--MEoE-EX-B-BXEMXX?EB-M--MBXo-EEXXEXEEMX-XXX-BEEE?E--EM-B-o-?BBEEXXE---XXBME?E-E--XoEE-E-XXo-
--XEo-o--XEB?XXoEX--?-?--X-MM-EEE?X--EM-E-MoEMMo-X--Xo--EX-EE-?MM-B--EMXBE--X-Bo-X-Xo-EMB--EM-EEBXoE-B-BEXMB-EX-Xo-XBXB--EoBXEooXMBXE-EEXXoBEXEEXMoEoE--X?XEMXE?EXoX-?--oBo--XXX-EEXXX-EX-MEEXEXBXBXoEo-
-EX-XXXXEB---EEo---Xo-----EBM-XXEX-XEB--Mo---X-EXEXB?--X-Xo-BoX-EEE-X-BXXE--XEEEMX--o-B--X-EBo-EE-EoX-E-X?-EM-X-X-E-MEMX-?X---X-oBMo-E-EEX-oo--MX--o-?-MX-XXEXEMB-oooM-ooXEXX?-XE-BBX?EoE-X-oE?E-E-BXXX-
-XXBB-BE--EEo-X-?XXM-EM?--EEX-E---ME?o-EBEoE?--o-XM--Eo--B-EXBE-o-EMXo--BB-X-E-oE-X--E-EEEo---EXXXoEX?XoEX---B-oEEoo-EXXBB-X--BEMXE-Eoo-EX--Xo---EE-?--E--BEXo--EE-EXE--E-o-B-BEX-MX?XoXXEoX--X-EEME--X-
-X-MM--BB--XXXXo-?EMX-EB--E--BoX--X-XE-BX--oEXMEoE-X--X-E-XMEXXEB--XE-BBXMo--Xo-E--EE?EE-XEXEX---XEXE-oEE-EM-XE-X-B--EM-M-X?XEB-MoEBEEMM?oEEXXB?--?E-oXXXBXBE-X---oXXXE-EEXEEEXM-oX--E--EX--oo-E--M---Ev
-XMXEoX-Eo-BEo-?---o?E-XX?-?E-X-EE-XEX-B-EX--E-E?Xo-XXEoM-X-XXoEX-ooEB-BXEE--oEXB--X--X---XEM-B---oXBXMXEoEBXooXEBoM--X--XX--E?BME?-X-X?XM-BEX?-B-XX-?B-X-B-B?EE-MoEE--E--BMX--E--Bo-X-BX----X-MXE-oXBXf
-o--BE?BX-oB-EB?oX-Eo--?MoX-XM--oX-E-EBo--X-EE-E?X--E-M----XEX?XBMEEEE-EXX-XE--EM-EE--X-XX-XXoXE-XoBX-XXX-XXMo?B--E----X?EMXEEMX--BBEBX-EE?-M?BXX?EXEXXo-?EE-B-XoBoXXXXE--XMEEM-XoBBBEE-XXBEBMEEX-XE-oXf
-?XEE-BEEEEE--BBMBE?-E-E?EEBEXo--oEM-X-o-XEoEXXE--XE?oEXM--B-XBEX-XEBEXEoB-E-X-EX--E?-X?E--M-XX-B--EXEX---XB-X-EBE-o--E-E-X?XMBEXE-E-BEM-X-XMBX-?XEX-oo-XE-E---?E-EoBE--EoBEoEEB-oMXE-MEBMEXoBX-EMoMBEEf
-MBE?-ooEoBXoE---EXBoXE---oE----o-?XXBM--XEEE----?EX-oE-EB?-EEEBEoE---M-EXEEB-?XoE-BooE--EXX-X-X-XXXEEo?EEE-E-EEo-X-E-B-XEMB--XM-BoB-XEX--oE-?M-BE-X---B--X--X---XMXMX-Eo-X--E-MEo----Xoo?EX--X-BX-MEE?f
---X-XEE-X---oX-BMM-E-XXo-?-XBBE?--oXXBB-XXX-MEE-EEEXXEoE??oXEE--BEBoEMoXMX-EEXEEo-E--X?Eo-M?-MoX-E-?Bo---BEoB-Eo-XEX?oB--X-EB-?X-XEE--MoBEBE---XXE?MXE-XEX--EoEXXE-Eo-BoE-XBE??E--E--oo-ME-XBBXMX-EE-Xf
-EBB-o-EXB?-B--XE---XEB-Bo--E-E-o-MBoXXBX---EE-X-XXEXB---?BE-?-EX-XXoE-XEE-XX--EooX-BX-B-oBXXM---B-XM?XXoEXX-E--EX-X-Eo-EEXXX-XX--?E-B--XXM-X--oo?XE?E--BMEo-X?Xo-E?XoX-B-EXE-X-E-MXooXM-BE-XX-XE?B--E-f
m-XEEE-ooE--?M-E?-XE-EX--EE-M--EXoE-EM-XE-X--oE---E-B--BXBoEXX-o?-EE--oX---BoMXEXEB-?XXo--BB-X-E--EE?X-X-E---XM-Eo-X-oooXE---o-X-EEB-XE?XXE-XB-XBE-------?X-EB-BMEo?--BBE-E-?E-oBX-XE---X?-EEEB?EoX---XX
XE?--Mo--oE-E-XBoXBoEB-XooXXXB?M-EX-X?X-E--XE-X-XoE-X---?ME-EoE--XE---o-E-XX?-Bo-X-Xoo-X-oX--X-o-?oEXEEB??-o-E-X-XXE-?MBXBB-XoX--MXB-X-XX-B-EMB--E?-XE-XXEX-oE-MX--?oE-B-MBEo?XXBX-EB-XEBM-o----EEBEXooX
