-----B---M-X?X-X-X------oX-MB----X--------Eo?-oX-M-----B-MM---E--------oEM-B----X--o---?--B----?-M-------o--o--M-?-B---B-?-E--------?oM--M---M-M--B----M--o---E-M------oE-----B-E------------E---M-o--E-
----EEo-o---EB---B----------M-----EX------o?-BE------X----Mo----?------E-o-M-EBo-XMMX?---------B-X-?o--oX---?-----o--B-X-----o---?M-M--?-M-o---X-Eo--X----M----E?M--?------B--o-M-----o-oM-B-oE-B-B-o---
------MM---M---M-------X---B-----X--M-?-E-----?--E-ooB--oEo-M-o---?---?-o-----X-------B-Xo-o-XX--?---?M--M-----------MM-E--X-?----B-----?--MXEMoM?-XM---E--?--------B-B------M----------E-MX?-M-B--?----
----E---B-Eo-o----E-M--E---E?-M-?--?XBX--B--M----E-B---o-??--E---E-?------EMB-BBo------X-------B--?---M----M-------?-B-B--E--?-E-----X-----?---X-----M-Bo-MX?ME--o?----M?-M------------------------E----
----?-------?o--X---MB--E----BBX-?-oX--o----X-oM--M----M--o-----oMM-X---E----------------------X---?-M---------o---------M--X---XX--?-B-B----o----------BX-B--XE---E-----o-ooo-B--Mo--oEXB--X---E--B--E-
-X-------XoE?o--------?B--E-B-?--o--X-M-------XM-------XM--------E---?----B------M-B?X---?--E-------M----EBE-------------Eo------?M--o-?----?X-M-B---?-E--o--oB-Bo------X----MBB-M?-----?-??EB--o-----X-
----?-BMM--o-B-E----X?-E------MX--X---B---B---?--o---?-o?-----?---EE-E--o---X?----------B-E--E--X-----M-----?-B--o--X-XM-M-EM-----?-o-oB-o-BE-?Bo-XM-X-E---o----------X-XEEB----o-----?---XE-X--------M-
----o------?-------o------B-----E-B-M--E-M-B-X----?---------?EB---MB---?----Bo-----E-EM---------X-o---M?----X?---o--B--E--XB-B-BM--E-EX----Bo---B---Eo?-M-M---Xo-----BX-X--X-BoB-------M---X-?--o---o--v
--X--?------o??----EBBX---B-o-B-M--?-E--o-----MX--------?---X-M-?X?----o--B------o-E-------E--X--E--X---Mo-----XM-o------Bo--X-?-----BB---?---M--M-?-?-M--X--E--B-?---oX--o--X------BB------o--------XBf
-----oX-E-?X?o--XE-E-EB--M----------M---------B--BoB-----B-E---?-B------B-M---X-X--------B--o-BMBo----------E-X-B------X--M-B--------?-------X-?M---E--ME------M----M----MB-X---X------oM----Xo--o--E--f
----?-o-------M-B--oMBo------------oX-?----------EoE-oEo-----o-o---?----------M--E----B----B--?-----o---?MX------o---X-oX----MB-B------?-M---------E--?M?-------?--?-----M---BB--B-------E-?--?---o----f
-M-----X-o-B-XE----E----?--oX-?E---X----X----E---B?---oE------E-?------?---?E---X---EB--BB--MB--o?-B--?X-----B?-----X----X----------E--M--B--o---MX---------?-X----E--E-o-----E---B--XM-?---M--E-B-M---f
--------X---E--E---X--M-BMM---MB--E--o---B-BE-Eo-------X-----EM-------XM--------X-----o--XM---M-----M---M-------X-------B----------?---oM----Mo-EM---EBM?---M-----M-----?-o----?----E--BB--?----X----X-f
-----MBo--X---M--E-------E------?--o--o-B--------B------?--E-oMB?--?-M-------X-----o---ME-------ME----?----E----?-----o---------??-----X--E---B-----M-----E---?------o---BE-XM----B---X-M----o-----X-X-f
m-E-?---?-oE-X--M--EM---X---E---?o-o----------o--X---E-?---MX--E-E-----oX--Eoo--X-o------?-E--B---X-?-E----o-M-----EoE--------B--X---EME-------EoX---BoB-------X---XB-----o--?-M----XM-B?-o----?---MX--X
XXXXXMXX?XXoEMXXXXXXXXXMXXXX?XBEoXXXXEXE?XXXXoXXXoXMXXXXXXXBXM??X?MXXXXXBXXoXMXoBXXXMXXXXoEXXXXXoXXMXMXXEXXXXXEXXXX?XXXXXXXMXMXXoXXXXXXXXXXXXoXXXXEXXXXXXXXXXXXXMXXXXXoXXXXXXXXMXXXXXXXXMBXXXEBXXX?XXXXX
