-oo-E-o---B--o-Bo----o-B-E-o---?-?-B-E-----XX--X--------X-BBE-----B-XM-E------E-?M-X----o---------------MXX?-Eo-----E?---------Eo-------M?------?------EXX--XM--?XB-M-X-Bo--?------o-------X-XM-Eo-M-X--
-?---E---X--?E----XMEBXoB--M---?o-?---E-----o--X--?-X----EM-o-XX---X-?------?-B----E?XX---EXXoE-----X-X--EXX-X----oE?o--B-?----?-----X----?E?--M----B-E----XXB-MM-BX------EM------X--B?EM-E----?-X--M-E-
------?-E-------X-M----E---X--o---X---?--X-----MXM-M-EE--B---E---B---E-B-o-MX-M----X---X-M--------X-X?-E-M--M---X-oX---M-B---X---X-------M----X?MM-----o--E-o-M-X--M---?-M---X-B-BE---o---?----BXXE---?-
-M---M?X--E---EME--B--M---Eo-X-----X----M-?EEEB---X--ME?X----M-?X?-o-oM?-M-----X?-------------M----X---o?X---?-?-----X-X--M--X--?X---EEE--?-o-X-EM----o---------B--M----------X--X-EX------M-o-X?-------
-?o---M----o--X---o-?--------oM-?-E-M----Xo-------o----M-M-X-XX---------BXX---B-----?-------X-----ME-E--X--o--X-oM--Mo---BB-X-?--B-X-----XE---M--oX?-EB-XXX---?EoEoX--------E-XX-X----E--XX-B-o-E-E-X-M-
--X----B--M------?-----X---?-X--?-----X-M-------?---oX-XE-----MM--MM-XXoX--X-XEM--X-------XX--?EEo-MX-------XXX-XBB---MX----o-XX---o---------------o-----oEE-?---B--X---?----X----BB---M--X?M--XBXE-o-M-
-?-BX-o-o-E--M------EX--E--o--?---BM---X-X-X-----X-o--EX-------o----X--X--EE-Xo--EEB----?----B-----E-E--XX----E---o---X-----XB-?o--E-------M-X---X?-X----X---XE-M?-----M----?--X---Bo---EE-------XE---B-
-oM--X-?BXXX--M----X-----BoMMX---E-X-M--XEEoBoE--X--B?-?--?M-M-----X--X--------XoX----X---?E----E----X--M----------B-?o-BBMXB----E-M----------M---B--------o--o-M--B-o--XEXE-E--M----M-EB---M-X---oB-oXv
---?---MM-E---X-oE?X----X-------EE-X--XEXX--B-X--------X-o?--E-----X--o-----?o----X-----XBB-BM-E---EM----B-?------X?-B----X?M?-X--B?o--B--B---?M--X----B---M?-o---M--E--o-E--?--BE----X--X-B----?-----?f
---BM---X-BMX--X---XE-?------B---XM--B-B?-?----E-----ME--------?---X-o---X-M---X-o-M-?----X----?X-------------?--E-----BB---oX--X---X--B--X----BM?------E--EM----Bo-?-------B-------X-?--X--M???-?--B?Bf
--------?-B?o-Mo---M--?---M-B---?-X-------EX-------X---X--X---X--o---EMEXo-----E-X--------Mo--?----B--XX--------B?BXM--o--M------M--?--?X-------X-X-----E---B--B-M---X?oX-M-B--X--X-XB-B----M---o-o----f
---B?-------X------?---E--o---Mo-oX-EB--XM?--EBEX-----------X---o----Mo-X--X--------B-M--X-X----XE----------M-E-?-------E-oEEo-o--?---X------XE-X---E-XX-o?-X-------MXXo--o--X-?X--?oM--?---X--?--X--B-f
---B-MM--X-M-----Bo--X---B-XoBB-B-E---X-o-X-X-E-----X-----B-EB----E---M--B-MM-B----?---MBXMB-----XXMXo?MM--X--M----B----E--o----XB?-B---?o-oB----------ME-oo-XE-X---X-------?-B-BB------o----oXE-?B-oB-f
-B-----Bo----MM--EME--X--?BX-B?---BX-----------Xo---XEX----o--M??------M--Eo-----X-------XEE----?-EX-?X-----M-??B---M--X-------M-B-BX---X---M---E---X-X?---MX----M-?-BE-B-----------MX-X---?---??---M-?f
m-E?-E--o-B----o------Xo----X-E-X-E----BXM-X-M--X-E---o---XE--X-?--XE--B-X---?B----------X-?-X---X----XE---E-----?-----?-------?o-----o-X--EX-------o-------M--E-E----M--XB-MX--XX?oB?X--E--Bo-----M--XX
XX---X--E------o--E-M-E-o----X-?--?-E-M-?----?--BB-o--?E-o----o-----X--E----BB-?E-----EEXo--Xo----B----X?BX-M-o-M----?------X--BoB-X--EB--X--B?X--?X-X----M----E-oXB--ME----------EE----E-o-MBMB--X----X
