M----E----X-----E-o--o--E------X---------X--E-----X------------X--X-----Eo--X----E---o----------------o---------X----------E--------X----o------------o--------------o-----------XE---X--------------XoX
--E---E-----------X---X-----oo-X--E-------------Eo-----E-----------o----E-----------oX--------------X--o-E---X-------------------X--E-XE--X--------EX--EX-----------oE----------------EE---------------|
T-------------------X------oXE---------------X-o-------------------X--E--X------o----------oX-----------E-----------E--------o----------E-----------o-X---------X--------------X--------X------E--o----X
o-------X-----E---o--XEX--------------------X-o-X-----o------o----------E----------------EX---X---------X---E-------------o----X--E-------------X--X------------------o--------o--o---X-------E-E------B
Bo------E-----o-o-XE-X-------X---------------o-o----o-----X---------------E-E---E---o---o-o----X-E------E-----------E---------------------E--------X-o--------E--E-E--o-----------------------X-XEX---E-
----------------X-o----o----------E------X----------o---------X-------o---------X-------------o-----X-----------o------o---X--------------X------------------X-------o-X----X--X----------o-X--X-----o-?
E----X------o--------X--------------o----o--------------E----------X--------E--E-E-o--------X----E--o----o------E----X--E---E---------o------------------X-------------E------o----o-o--o------o-------o
T----E----o-E-o--o----------------Xo----------E---E------E--------------------X-----------------------------------o--oo-----X----oo-E---------------------------E-----XX-----XEoX---------------X------v
|B---M???-E----------X---?B--?E---o--B--?--Bo??----E--o-?----?B--?-X?---o----X---B--?-?----?-?B---B-------------------EEB--X-----X---XMo----o--oB------B-X----o----?--?E---X-------E-?--o--------XB-o-M-
B------------X-----B-B-EE-B-?-E-MM--o---E-E------?o??-o-E-B--X-oXo--o----------o--M--o------?-X-X---------X?X--?--X-----B---Xo--o----M-EMB-----o-------X--------X-----M-------B-?-B----?-MX-?--Eo---o--B
oE--?-?--E----BM---B--?-------B--------M--B-M-M--o-E?---o---X--------E?----X-EEM-??---o-M?--o--M----E--o----E-----E-----B---------E-------?-Xo-----Eo----M---M-E---E------?----E--BBo--------EBE-Bo----T
M-----B---ooB-?B?-M-X-?-o--BX--oB---B-oMo--BM---B-----E--------X---X-B------?--M--?----M--------?-X---?o-B------X-o--?-BE-BB--BB-M--X-------EX-?---?----E-X---MoM-B-M-EX--oE---o-o----oB----o-o-X-E?---o
|-----o-?-??---M-----oX-X--E?-X--?-------?-?-BBE?-E------M?--E-X-----XM?-X-B-X--EB---oXo---XB-E---X?o-X----B----?----X-Xo-------------?--?--B---E-?-B---o---X--o-B-----X-M---BooM--B-E--?B-----E---X-B-o
Xo-X-?--B-E-??o-B---MBM------XX-E------M-?--MB-----Mo--B--------X---?-----XX-E--oEB--?oE---o-X-BXEX---XM-XB--X---o-B-E----M--B-----------------X---?-MM-------?--oM-----M--o---o--Xo--Xo?--oMB-----EBME?
m--B-BMM--B--o-----------BBXE-oX----oEB----BEM-?--?E-----o---o--XoM-o?-Xo-?oEM-----X---M----o---o--M--E----?---EM--EoM?E-B--X---E---E?E--------M?-M-XM----BMMo-BB-M----oB-E----EBMX-X-o-?-B-X-XM-M-----X
XXEX?XoXXX?XXXXXXXXXMXXEXXXXXX?XXXXBXEXXXMEXXXXXXXXXoXXXXXoX?XEXXXXXXXXXXBXXXXXXXX?XXXXXXEXXXXXXoXXXXXXXXXMXXXXMXoXXXEMXBXXXXXEXXEXXXXX?XoXXXoX?MoXXoXBXXMBXXXEXXXBXXXXEXMXoXXXX?XoXXXX?XXXXXEXXXX?XXEXX
