-MXX----X------?----B-B-BE?o-----oXB--X----M---o-----EX-o-EMoM--o--------X-------M-M------X-X--X---?MM---BoE-----EX----o-----Boo-BooBBB----E-X-E--MB---?------?o----B--o-X----E--XB--oX?-------B-----o--
-M---X-----M---E--E---oM--?-BX---X--M---M--MEX------?-M--B-------?oB----------X-Xo---------Mo--EMEB--?--XoXX-----B-?B----Bo-----M----o-o?----?---o?E-E-o--B-----o---o---BMM--B---------------o--M--E-X?-
-M-B-E-M-XE-oB-M-----o--M--M--B-------o------M-----?B-?--E----o---?B-o?--BM----ME-X--------------E--BX----X--?-----?-o-M-Xo------E---B------B-??----XB-M----M--M-M---X--E-------------X-----oE-X----X---
-B-oM--?-X---E-------E--?--X-B-M-oM--oEX--------X--M-B---------BB----B--?--M-M--X-?---?--M-----BM-------E--------E--E-E----o-E-M--o--XX?-o-o-XMB-----Mo--o-E----o-----E-X-X---X--?-----M---X----M-o--M--
----o-o?X-o-X---------X-ME--B?E--MM-M---oX--------?----?---M-X-M-?--E-----o-B?-o--EX--B-M------------X-BoXo---X---o-XM?--M------o---B------o---?-?E-EE----------oX----E--B--B--X-B---------------B-B----
--M-XE-BM--------B-?E-?B----------X--Mo---------------X-----XB----B--B------M-ME-------?-o---ME---------M--E--B-XMB-----MEX-------?EE-------------X----BMM--?-X---oM?o--EX------E-X-M---B-X--B--X-------
--E?-?-B-----oB-----XX--o-BMEo---?---?--?------?-?---E---X?o------X----E------o-----E-E-o--------oB-------------X--------M-X------E--EE--X--M---EX-----o------o------M--B-o-Mo--B-EB-MooE-B---------X---
--o-o-o------X?-----E--?--oX--E-MX------oE--o---E?---M--MBX---?EE-o----M----M----------------o-E----o-Mo--------?-------oE-----B--o---------M-----o---B-XM-----o------E-M--X-E-?M-XEBB-----Mo----------v
-X-B---B--?---E-----M--Eo?M-------------B-M?-?--X--E---B-oX---X--B----X?----?oB---------XM---oM----?--------M----E-----E------?--X----Eo----o-o??--BE----o-?E-------MM---?EB---------M-----X--M------o-f
---------EXM----M---M--BoM--o---------o-X?--E--M--M--------?-E---B--B?M?------?--?-Bo--------oM-?--M----EM-E----M----------E--?o----M-M---------X--------Bo--MM----?-E-M?o--o?--------o-B---M---oX-----f
-------E-B-E---X--BX--?B---MX------?---B-----MB---B-o--M-XME--E-oM--------o?o---X------o-?X--B-?------X-B----------Eo-o-----oM--MB--BEo--oX------?--?---?----o--X-o-----MXE?Bo---oo-B----B------X-----Mf
---EE------oM------?------X-----MM--B-??-------------?---B--?-BX---E--------X-MM----X-o-----o-E-o----Eo--E-----B--XEM--?-----X-E--?X-B--EX--MM---M----M-Xo---X---E-?--------?-BMo-?M-----X--E-oX-M-----f
--------o--B--------------?o-----BE-ME-oM-oM--------------?---E-?----?E-EE?o-?-E----X---------B---B--XMo-----E----X-oo-MM----XMBE------XoE?--XB-----X-?ME-M-----M??--------?------E-X------X-X-BX------f
---?---?--------?-----B-?---o---?E-----o---o---BoX-X-B--M--E-XX--o----oX?-B?---E--?---M----XE-----EB------o-?------------?B?-E--?-----o?-----M-B---B-E--?-----B?-----?X-----o----X-----E-------E-E-B---f
m-M?X---?-X?------BXM----X--M-X---MEB-------B--o-----oBoo?------?------Mo----------M-oB---?-E--M?o--E--?---oMo--o--o--o--M---E--B-M--?--XMM------Mo--------??--E--------E-----B-E----M--------X-E------X
XXBXoXXXB?EXXEEXooXXXX?XXXXEXXXXXX?EXBBoXXMXXMXXXXMXXXX??X?X?XXXXXXXXXXXoXXoBXXXXXXXXX?X?XXXXXXoMXXEBMoXBXXXXXEXXXXBXXXXoo?oXMXX?XXEXXXM?XXXXXXXMXXMXXEMXX?XMXEMXMXXXXXoXXXXEMBoXEXoEXXXXMMXXMXBBXBXXXMX
