----MXXX--?oB--o-o---EE-X--------X-------X-----B---?oXX-X--?---BE--M---?M--MX-BXB-XX--o--oX----B--M-o-------MoX----X-X--EM-----B-?XX-M--X-X-E-MX---E----M-----EoM-o-----E-MXo-?-X-B-----E-E---B--X------
-BoB-M-X---------?X-------?-----------E?----B?X--?---B?--?M---------------E-XX-?-oo---X--B--MEXXB--X-EEo---B-B---B-X---X-----?B----B--EB-?B-XX--E--XX-----o-XB---oX-----o-?E?---B------oX-------X-------
-E-BX---E-o?----X--X-------M-------X----X------M--------B-o-MX-?--Xo-----?--X--?X------Xo-M--oM--o----?-M-----oE-?XMEB----B--MX---X---MX-X-oo-B-EX--B-X-XBE----oX-o-?-ME---X------XB---B?---o-BMo---XM--
---XE----?----ME------------?XM-E--?---B--X--?--X-?-M?-----BX---E-----?-XM--X-X--E-------o--?X-M--X---o-X---X-M-------X---oBBM----oB-E--X-XBX-E-o-------X------o------BX-?----oEo-X---X----Xo-X--X-XX---
-E-E-M?---X----X-----?E--X----EX---?o--XBo-----o----X-------XB--B--o------o-?--M--XBX--MB--o-----B------?-B--?--B------------E--B---o---?-BXB---?EXE---XX-?-X--BXE--MX---o-?E-?-X---B--oX--?--o---------
-E---------EM---X--BX--X--E----XEE--Eo----M--X-X-------B-M----?-----?--M-oM----X-?----M---o---MB--o-----?MXE---Bo?oB---E--B-?---o-X---MXX--?EXM-------M---X-------M?oEX-EBEE-Eo---X-M-XX-----X?---E-MM--
----E--o--------o------o--X--MMEX--E-oX----B-oM-?B--XE----Eo---o----X--E?XX-MEX-------X-o?----B-M------XX---B-X--E-------EX-MB-----E-E-X----M--EE--X--?--EB----M-?X-XX----BB-E----X--X---X----Xo--?-----
-X-oM--BXX?M-X--X-----?M-X-?---o----XXM----?-B---MX--X-E------MB---------o---E-B-B-?B-------XE--Mo----M-----B---M-oB-----M-X-XB------o----X-B?M--MBX-X--o----X---?----X-E----o--M-XEX---BX-M--X----X-o-v
---?--B--o----E-o--o--X-X--X--EXX---EM?------MoB-----X-?EMM-oB-X------EX-?B-E-----?----------E---X--?-B--Eo-X-o--------------X-B?E?--EXXXB--E?---X--o---B-MB-BXX--X-B---E-XXMo-XM-?----X----X-X-XX-----f
-------------MoM--X-X-----X-----M--------E--------XM---M-----------?-?---B--o--?-----X-?B--XBE--o-X----X----X-?-M-----X-o?-M-----BM-Xoo-?-?----oB-EX-?-----M--XX?o-o---B--XE---BM-X----B-X-X---M-X--X--f
-M------X----Xo-----X----E-E----oEB-BXB--MMXB---B-B-?-o---E--XE-E-oX---X-B----?EBX?---?X--?-E-------oX------B-B-?--?B--------BM-----M-------Eo----o--BX--EMBB-------?o-XXX-----------o--?--Xo--BMXM-E-Xf
--?BX-----E---o--?------oo-------X----?--X-----o----M--MM-XBE-XB---BEE---X-EB-Bo-X--X?o-X--?-M-------?o-X--X--o--E-X--M---MX-XX---------?-M-M--E?BoXXX-?oE-Bo-M-oX-X----B---------B-MB--oooX-MX--X?----f
-----B?-?-BMM-M?B-Bo------X------EoE--o------M--M--------o-M--o-B--B---B---E--M-E---X-o-X-------o-------M--?-?-----X-E??-------------X--X--Bo-M----X----M-----?M-----X--X------E---BBXXX------M-----E--f
--XE--B-XX--o-o-E-?---XE-o-?------E-B------E---o-X-?--X----BoXE-M-o--------E-------?-X?-------B---X-?----M---XX------X?B---X-------------X----o--?------XB------oBE----o--M--------o-?-B-----E--?oMXX--f
m--X-o------ME----o--o-XMX--BMX?--MX-----E--------?B-oX-?X-----?----?--E----?-X------oo----EB?-E--M-B-----X-XX--?----E--?-E?--X-BB-?--X--E--XXE--?-----X--M----------X-oM---?B--X?--E----M-E-B--?------X
X-M-?o-E----X-E-XXE-X---E-MXE-oB----EE-M---M---M--E--?--BXB?------E--?M-M-BXEE--o-----oM------E--BM--Mo-?-E--o----?----?--?-EB---Xo-MB-X---M------?----------B?oo-B-E-M--B--BE----o-XXEE--o---o-o---?--X
