-X--M-XM-------B-o--B---------oX-X-----X--X-XM-----------XX-o-----M-X-X-MB--?B------X--M-X--B-E-?-----XoE?------?-E--?---o-X------X-B--MX----X-oX-??-M---?XXBX----XB-MBB?o------o--E----B-X-E-XX----X---
-M--M-------X-----X----------------M----EoBB---------B-----B--B-----B--------o------X---E----?B--B-----?-X--XE---X------?-XB-XX--M-?-E-EE----BME--X?-oE------------E-X---E------------XX?--o-X--ooX---o-
---X--------oX-oM---X-----XXX-o-Xo---X-M-?---M-BX--?-X?-------?BB--X-?o-MEBM---?-BXXB---M?-XX----?-?---?-------o----?-X---M-oE-X----M-?-E----?-X----BX?B------EB--B--oX-?XB-----------o-XXMXBXB---o-----
--?-o----E-o-M---EXM-----o-----o------M---------XoB-?-o-MB--XX--MX-----X-----o-X-M-E-B---X-?-X-EEB-EM-X---X?-EB-X-o---------Xo----BB--MM-M-X-o--------B---BB-BB-----E---XBE--B--Xo--X-E---B-----XX-E----
-?--M----XB-XM----?EE----------E?-o--------XX--BX-o---E--X--ME?B----M-oX----oX-EE?X--E-E--X------?----o-?---XEEB-E----X--------M-EEE-X-----X---EE----oMo-?-----E----?----M?-B-----M---X--EX-------XMB-o-
----B-X--X------EX---X-X-----XEX------?-o--------M-------XX-M-E-----E------?-X-------oM--X-ME-?--BM--X----X----M---B-M----?X--B?----?-----oE------X-oX-o----B-----X--B---?-X---BX-----M--X-B----o--o--B-
-----E-X-EE---X------oo--X---E--M--E-E---?------X-X--X-M-E-EXE--X-?-o---?-o--XMM----------M---M-E-oEME-o--?X?-B---?-----oM---X-XE--o---BX--Eo--------o-B---------XX---X---------E-----E--X--------?X--M-
---XXB-----EX?-M-X-----E?B--B--B---M---MoB--X-XM--E--M---?Eo----------E-----B--?-------?M?B-----------XEo-oXM-?o?Xo--X--EoX---M-o-M--B-?-oX-E--ooE---Xo-E---EBo--X-B--MB--M---MB-MoE-X-X---X-B-X-----M-v
--X----XX--Xo--X-----EM-E-M?XMX----B-------------XBBMo?--XXo---X-M-?M-----E---oMEM-------M--o---B-Eo---M---Mo-----?---oX----?--XoXo--E--M---------X--?---o------XMEM--X-M-BM----B-B--------------X----Bf
-o-?--E--o--M-----------X-------EXoo--o-X--M-M-----E-?----E----o---M---B--?X----------------M?------X-?--?----B-MX--E--Mo--M--B--o---X-X-M--o?----XoE--E-----oE---E---M------M?---X-X--M-EE?--oB----BXXf
-----o-M--M--XB-----X--B--------X--X-?---X--Xo----BX--?EoB-?Mo--------B----M---o?EoM------?---ooo-BoM-----X------X-?--o-XXB--EMBMXB---X-----oXE---B-E-X---Xo?-B-----X?----o---------------oM---X-----o-f
-M-B-o--E------------B-M-oB---M----o---oX-?E-o-X-X--?-----MXB?---------o----X-----B-X-o?-?EBEE-E---?---------E-M--o---B-Eo-----?---X-XB--?--B--M-M-?--?------XM---?-------?o-E--oB--Eo-Mo--M---X--?---Bf
-M--B----EM-M-B-oB-----E--oM--X-------X------?---X-----?oX--X--EBB----E--X-o--E-BX---o--B-X-B------X--M-----oo-E-?-EBX--X---B-------oX---M-B-?----?---MX-------o-------?--X--?--X---X--XEX------XX-o---f
--oXE------EXoX---XE--X--X-o---------o-----M---o---------XM---X--E----E-M--?-XM----------M----?---------X--?X-BB-----M--M-Mo-o--oB?---BX----X---?---?-?E--M-----?X--B?o-X--B-E-M-MM----o------E------?-f
m--M-?oX-----o-----M-B--o--B-o--XX--EM----M-BB-B--X-B----MMM-?-BM----?----E---------E------------o-M-----X---E--o-?-M----oo--EEX--B-X----?-XXMo----o?-Eo----o-----M----?B----B--------XE--MX--o-E-?E-o-X
X--M-?-E-B-B?-B----?--MB-?-X--?-?-M--EM---E------XX-E-?--X-------------?-oB--M-?------XE--E--Xo-------M------B----------XMX--XEBX-----o---B----MEE-M-M--EB-B?---BXX?o-----o-M--oB-X?BX-B------X-E--EE--X
