-B-M--------o--------E-?M-?---XX----M----B------B?------BM---B--oo---X----X----o-X-MXoM--E----E-E--o----o--XX--?-B--X----?-----X----------M-B-----M-----EM-----o--oXX------E------o------------?--------
----M--BMM--BXM--EB-------------E---E----------E--ME--o--B-B?--E--?-M-----E----------X---XX----o-B------------M--?o-?------B------Xo---o-BE--------o-E----E?-----o-E?E-------------------?--M--E-----E--
--E----?B-o--?--MX---EB------o?--B----X---E-------?---------X-----?-EM----M--E------?---B-o--------B----E---o-B-?M?-----------o--M---M-X-M----o--o-o---Xo---o-?M-----o--B--X-E--X-?--E----MM---oB--?--X-
-----XE----E---M----------X-MBo-X------------MB----E-?-------MB--E------X----------XX-MM---X----M?---?--?-?X----M-----B-oB---oo-o--o------------?-----M--o-M---?-B----X----M--M-?-M--M---?---E-M?--o----
-E-Bo-X---M--------X-MMB-?---?---E-Mo----o-----?-o------?------B------?-----M--oE------o-------oXBXo--B--M------oM---------------o----BE--M--B-------E----------oB-BM----MX---?--?--M------E--X---o-?-X-
--BE---------M--X---?-----?BXX-?----M----?-o--?----E?---------E--------o----B----MMo----X---o-------EoM--oo---?--?M--B---?o----XM----oo-----E-----X----B----X-----?oB-X-M--??-----Bo-X-------XM---E---B-
--o-E--B-------BE---------o---EM--E?-X-?--------XEX---o--o----oBoX----?B-M--X----M------B-----M--X-M--o----B--X-B-o---MM-o-EE------o-o-----M---X--------?----X---o------X--M-MBo-o?MX-----M---B?XB------
-------?----E----oM--------o----X--X---B-EBEXX----B--E-E------M-MB-B-X--MX-E----EMX--ME?-B-o---M-----B----X--?-o--------------B-----M-E----E--oX--MM------E-------EB--?-----o-E---M--E-------E--M-B-M-Mv
---E-B-BM-E-----E----o-------oE-------E--B-----ME-EB--M?--------------Eo-X--------?--oX-B--EM---X-----X-B-E-E-E?B-o----oEo-?--M---------B-X------?E-----B--EM-----M-E---o-XX-o---?X--M------E?-----M---f
--oMM-E--o--o-MX-B-Bo-EM----E--E-----o-?MMo?E-oM------------oM---M-?--B---M-E--X-X------E-Eo--?--------X--oM----?---o--M-------E--E--E----EX---MM--------B----------M?------------M----M-?-----?-M-?---f
----X-----B-MM-X---?--X-M----o-------EM-MM?--X-B--------?--X--oB------XM-?B-?--MM-o-X--o-E--?-B?-B-E--MB-EM-M-?ME--?-Mo?M-?B--MXBMo------XBE-B---?-------o--?------o---E-E---o--BE-MBX-B-o-E-?--------Bf
--MEB--------?--oEM----E----?---MM-M---M----X--------E---o---M-E--EE-o--------------X--B---MX----------------------B--------?----B-----E--o-?--------------E--B------------Xo?--M--B-MB-M--------E-o-Bof
-----?------o---------B-X----X--MXX?----------E---o-------B---B---E-MB-------B-----M-M---------?--------M-o-------B--o----E-B-o-M----B-B-BX---B-X--XBE-EXM----BM--M---BM-B-?-o------X-X------------X?M-f
--X--B-oE-?E-o-E----M---oB--o---E-M---------BX---E----X-Eo?o-----M-E---------X----o--M---E?-X-----------M-----?---E--E--?X-----?-?--BM----------M-M-----M-X-?-B-----?--E----M-------E-M---XEBE-----oo-Bf
m--?E-X---------X-B-MTM----?----TB---X---BXMM-----BB-MB-------------T-o---?MX---XX--TX-----T---ET-MM------T----B-TE--------TE----T----B-------M---------oE------To-o------Mo--?-M?X--B-----T--M-----E?-X
XXXXXXXoBMXXXXEo?XMoX|XXXXXX?XoX|?XXEX?XXXXXXXXXXXo?XXXXX?XoXXMXXBXX|XXXXXXXXXXXXXXB|XXXEXX|XBXM|XXXXBXXXX|MXXXEM|XoX?XXEXX|XXMoM|XXXXXXXXXXXXXXEX?XXMXEXXXXMBXX|XXXXX?XXXXoXXXBXXXXXXBEXX?|BXXXXMXE?XMX
