-XM-----EBEM---B------X-----X-----X--X-ooB--o?X-----M-E------o-----X---Mo------?----?-------E------X---------M-B------X---?o-o-o?--X-----?-o--M--B?---?-----XB---------M--EM--B-B----?---E--o---EX------
-o--E----M-EE----M-BX--X--EXE------BX-Bo-MX----X?BM-M-M-------Xo---M-E--EX--ME?X-M---X?X---o-?-MX--E----X------MB--X--E?-----X----o------X-Xoo-E--E--------X-?E-E----?----?---Eo--E-----E-o-oX-XM-XX----
--??---X---XEoX-----?-E--oE--------?-XoE--X--o-XX--BB--X------E---X?MM?----o?B--?---B--?--M-------E----XE--E--M--B---??-EXo-oX-M?---B-B---B---MX---X--E-?o--XXoB-----oB-X-E------o?--BXX-o-MX?XXo--?B---
--E----X--------?o----X----------M--E-----X----E--------E--X--o--X?-B----X-X--o-o---E----B----E--------M-E---X-B-o?--oX-XBE---X?----XX-X---E---X--?X---MM---B-M---?--?E----oM---X---E-o--B-?------ME-X--
----M-----EB--M------XE-X---BX--X-XXB---E--o------X?M-------?-?----MX-XXX-X-------E-XX---?----X---B-XXB?--B-XX-X-----E---------M--M---?XX---M?E-EMX--EX--E-X--?E-EXo-o---X-XM-MBo-?--------M---E--?-E---
---X-o?--B---------MX--o?-?-----?XB-X-----ooM-M-?-M-X-o-?X-----X?-?--------------oMB-B-X-------E-o-----BM-o----?X---BM-BB-oE-M?o-X-BM-----oE----X-?B-M----B--X?---M--MXM----MXM---XX---------B---XE-----
----X--B-E?-X--BX----X-?-X------?-----E?-----?X?--MXo---M--B?---?o--M--E---oX---??X---o--XX--X--E-M----o----M-X-E------MB-oMX--?--------X-EEM-EX---M--X---E-------o-??-MB--B-?B--X--X---------?E--XE-oM-
---XE----Bo?-M-M---BM-BM-XBEEEX?o--X--X-----?M--o?--?X-?Mo?--?--B---M--XX--X-B----------oo-X-M?-E---o--o--o-XMoX--BE--XB-XX-MX----X----Mo------E--X-?o--MM?---X---M--o--o----E?-----X-X-?------X-oB-oMBv
-E-M---XB-X----------Eo-B-XX---o-M---B-M--?o--B?-oM-B--------XEXo--?----Xo-MXXE------B--o-X-----?oEB--oM--BBX-?---X------B-------------B--?-o?----X---X--o?X----BoX--?EXX-M-B---X--?----------?EE-Eo---f
--o-----E-M--Xo---?X--X--E--o?-----M----X-BE----EMM-M---M?BMX--?-?XX-E-o--o----M?-Mo--?-BBB----EB----------?---B--E-MMX---XEX------M---X-o--XBM-------E-------X----M-X?-B-EE-----MX------M---XXM-M--X-Ef
--M-o----MB-E-o----XX-BX---XEooMoX-M-B--X-Xoo-BM---M--------M----X-XoX------M------o-X--X-X--?-----E-----?-EEM---M-----X----MX-----X-oEX--M--?oEBXMB-B------E-XE-------oBX--M---EoXX-?-E----o--M----B--f
---BX-----B?XEE------XoX--B-oX----B----M----XoX---------E-?EB---EXM--MB---------B-----o---E---E--E-o--?M-B--o-X-----B---?--B--?BMBE---X--E-----oX-o--BXoX--X---------M---E---?X---B--B---o----BB?--?---f
--E-------E--B--o---E--oX--E-X-----?--XB------M?-M--o---B---?-o----?X-X--X----XXB--?--?-----XEX-o-X-?--XE----oE-X---X----EB-XE----------?----------X------M-----oX-----------E-B-----E-----?---X--B?-MMf
---EB--M---E---X?-EB--?-E-XB--X---------E------E--X??o-X-?----o--?-X---E---oE----?--E--M-EE--X------X----Bo-?-E-E--XXE-------Eo-BB------------o----B--Mo--MB-o--?-----Mo---XM----M--EX-Xo-----X?--X-E--f
m-MMoB???-E-B-X---B-X-oEXEX-XEMX-XXX----BB----Xoo-X--oX----XM------X--o-----?-?--XXBXo-o-M--------BEMB----o------?------X-?----------------?E-?--X-------B-----EoM---B-??E--X--X?-B-M---X--E?----X-E---X
XB-BM?---oM-?B-?XE-?--E--B--E---XM-?--------M------MEo-o---?M--------Bo?-X------B---X-----oo-o---?--E?--------B----?--MM-B---------E-B?--X-----X--X-X----BB-?B------B---?---?-XX---?-------o-BE-?-----MX
