----B--oo-------E-----E--M-EoBMo--------M-X--B?--o---?--BM-o--?----EM----?-----?-----oB------E----M-o?M--M---XX-M---E-----B?-Bo-----MBX-M---E----?----o--X--M------X-?----BMo-----E-------------X-B-----
-EM----B--E--o----E?------------o-E??oBXB------oE----B-BB----EE-EB-BoX--E--BE-B?E-?-----?-E----ME--?ME--X-M--o---?--o----?X--E-E---X-----?-----?-------------------E--------E?-----X--M-X-E-B-?B----M---
--E-E------XBB--------------------B-XE--XM----------E-----B-----X------B-------o?M--B-----E-----------X--?---?-----?-M---ooB-BM---M---?-E-E-?B--?-oX---?E--E----M-o-------?-o----oX-----o-M----oM--M----
--M-B-E?-------o----?--oBE------MX--?--M------X-o--E--XoBM-M-B---E--o-M----E----------o------------?----B------?B--------------E--XB?B-----o----M-----o------XB---o--------oX-------o-----------E----oM-
-B--B---M--X-o--?-X--oMo--BM?------?-E--o-------X------B--B--B-B--E--B-M-----EM-------E-o-o-?--B---X----B--------X--B--X--o-------------E---MM--o--X--EEBEEBXB--------B------M----M?-?--X--B---?-----M--
--------o-------E---o---B------M-------------o----oo------BEo-?-XMEB---?M----oE-E-B-------X--BB---E?--X-------X-M---?---M--------B-X--------X-oX-X-B--?-?E--M-M-?--o-?-EMo-----oM-o---X--------B-----E--
--?--B-o?-----B---?M-M------X----?-o-----E--ooB-------o-----o-----o-X-?---M-?-oE----E---?-Eo-E-?------?--EB----o?---E----?-----o--M----XX-BX--E--oMM---B---E--E-X---E--?o--BX-----B-X--M-----X-----?-X--
-?-?-MM-X-M-E---B--o-E-----X----oM-E-o----E------?----B--X-o-------BB?E-B--X----B-----?M-E-X----?--M--------o----M-X-o--M-?X---?EE--?---EXB----E-oMo----oE--?E--B-----------E-E----??-Eo-E?-M---X----E-v
-X--E------o--?-------B--M-?--X--EE-?---?-------EE-----B-?-----o----BBMM---E-?E----X-B?-----B----B--oMX--M--EX---XE---E-------MB---o-?--BM--Bo------XBM-----Bo-ME-E--EB--EE-------Eo-B--M------E---B-BMf
-B--E---EM-X-B----------B-?M----M----Eooo-B-?-E--E-?oB-----o-E--o-------------o----B-E--X----M-------X-M--------M---E------M-o-MMX---B-E--------B?--M-oME--------B---B------?-M-------X---Eoo---M---B--f
-E-o-o--oo------B-o?oB--------?--------------B----E?-E-------Xo-----?-?B-X--------Mo------o-?E-B---?o--?BXo-o------o----?--B-X------X-M---E----X-B-X----X-Xo---o-------?--oXoEB---B-o--o---------B-MM--f
-MX-E----------X----o-E---?-E--------?--B----o-M---B------o-----E--o--------oo-o---M----X-B--?M?--X----M---oE--?---Eo-----X-oM--o-------E------M?-----B-------X-EM-----X----M-BXo-ME--M--?M-----------?f
--?------E-?---o---o-EB-E------B---?-E--oM-----oX--X-----------?----MB?M-B---?---EX---B------M--?o--EX---------B-EB--B-------M-E------Eo--o-M--------X---o-------?-?------XM-----M--B--E----BX-B--M----f
--X-B----E?EXo---B-----------------X-?----M---M--oM---M-?--B--o-X-----o--Eo-E?B-------o------MB---BE--o-B---?--M---E-?---?-E--------?-----------oE--X--MMB---------B---o--X-oX--BME--X-?--X-----ME----Mf
m--E--M-MX------------------o-?----?-?--B---?----M-?-----------?----o-?BE--XB-MM--------M---X--XM---X-----X-?---o-E-X--E--B-X--------BB----Bo-X?-B----X?-----o-----E-----XX--------E-B---ME-E-Mo-----M-X
XXXX?XoXXXXXXXEXXXXXXXoXXBXMXXXXXoXXX?XXXXX?XXXXXXXXXXXXoXXXXXoXXXXXXXXXEBXXXXXXXoXXoMBEBoXoXXXXXXXXXXXXXXXX?XXEX?XBX?Xo?XMXXBXXXXXXXXXXXXXXoXXX?XXXXXoXoXXXXXXXXXXXXXXXoXXXEXXXXXXXBXXXXXXXXooXXXXooXXX
