-EX--------X?X-----------E-E----X--Mo---o--X-X--XB-?-----ME-oBE-M----X--?E----E--o-----o---?-----M--BEM----X---??--?-?E-----oo-M------X-E-E--B?E-B?--?-oo----X-M-----o-X----X---------E---------MM-M-B--
---?-E?-o--?E-B--X-------E-o-?X----M----Xo--E--------M---------o?M--?-----E-------?-M---M-----oE-oo-B---M-?--------------X-------E-M---E---XE-o----X-E-M--oE------M------?---E--?------oB------X--------
-?-----M-B------o--------E---------o-MM-M-?-Bo--X--M-----E-MooB------E----M-X-E-M--X?---X----Mo--o?-B--E--------E--B?-------------?--------E--------B-------?B---o?---B----M-----MM----?------?X--E-o?M-
-o--B---E--E------o----MM-----------E-E-?-?-B?-B-B----o-MB---o-?--------B-?E---B---M--oE-BM--------B-E-B--E-Mo-MEXMB------------BM---MX-----EM--EX?-----X-o---------BE-------B-M-------?-------------X--
---B-B--EB-X------------oB-----X-?X--E---E------X-E---E-B-----?---EEM-----o-B-?---E?-o--M----BB-------?X----?M-------E--M?--?------M?--E--M-------X--o---?X---X-E---M--Mo?-MMM----oE-?X------Mo-M----BB-
---X-E--M-Eo---M--o-BX---E-?---E------o-E--------Bo---E-B--M---?-M-M-BMo-------?B--------B----?-B-o--X---?-----X---XM-E-BE-----?M---E-o----B-o---MB-------------X---?---MX------?EE----E----XX-E----Mo--
-??---E-o-?-B??---M-B---M--E---M?o-oM-----X-----oM-B--oM--------------?M---BoM-M---oX--X?-----M-M-MB-EoX?---?-o-?----oo--X------B---o---EBoB---------E----------o-M---o-----oB-XB--E-E-o---?--XB-o------
-EB-B--?B------?B--o-B--M------E-----o----M---X----?--B--X----?Eo?------oo--------?MB-XE-------X---X-----B-E------M--o----o-?-----------B--?BXMMX-o--E--XB----?X------o---------o--Mo-B-MX--B?---E--BX-v
---------E---XM----o?----------E-o------o----o-----E-----E-M?X----------E--XB----B----B--------?-o-E-MM?M----XM-B-M--------M--oo-M?---o?--o-E---------X---o--?------E-B--X-XX----------o?----X----MoBo-f
---o-----EB--E-M-B-X--?-----E?-E-----------B--o-------------------E--o--?-X-B-E--o----?---oB-B?--------------o-E-oo-E--M-----X--B-----oo?--E----------------X---MM-------o?---oE?--X-----------------E-f
-EB??B--?---M--o-M-B-??-B---BBM------EX-X----?---B----o--B-----E-o-B-X--o----MBo--E-B?---EX--X--XE--o-?--------?----E--?-------?----B-?--M--------B--E--XM-?-ME-BB--X-??-MX?EM?---E--MB------ME--B--?oXf
-----XMX---o----B--B-------?-?---BM----------B-oB----?-----X---M-E-----M-X--o---------------?-?----------Mo-----E-?--E---?------o-B---B---E--M-------B---o---oXB--B---XM------oX-?-o---XB--?-MB--oE-X?-f
-----o----X----X?o-EBoE--B--X---o?--B--E--EMB------o------oo?--E-?X--B--o--E--------B-M-XB-B-Eo-BXE?o-----?--B---Xo-X-M--BXM-o-o---XMo--?B---o?X----?-EE------EE---XMB----M------B?E---B--M--o---X--oX-f
-MX-?-M-------EE------?X-?----?-M?-?-?-----X-----?B--------B---o?--?----?---M--o-E-----X----EE----MB---X-X-----o-E?-EB------E?-M-?B-----o-o-----B--X-M---E-E---oo-----o-?o----?o-----o-------?oM-B---oof
m-E-?--X----------XM-B--oT----o---------TTX-T-M?-------E--X--?---T-Mo?o-----B---E-M--oo----B--X--?X---------?---T-o--X-M------To---Mo-ME-B------oB---T-T-E-B-BB--------B-M-B----M---------M---ToT?----MX
XX?XXXXXXXXXXBXXXXXXXXXXX|XXXXXooXXXoXE?||X?|XXXoB?oXXXXXMXoXXXXX|XXXXXoBXEBXXBXBXXXoX??XXXXXXXXXo?MoXXooXXXXXBX|XBXX?XoXMXXXX|XBXXXXXXXXXXXXXXBXoXXX|?|XXXXXXXXXXXXXXXXXEXXX?XXXXoXXXXoo?XXMB|X|XMXEXXX
