---o--------M----B-----B--------E-------?E-------X---B---B----M-B-E---M-----M--EE--E----------E------XMM-M-o---X?---B----?----?oEXo-?--E-Mo-??--B--M---X---E-M??-----M---BB---E--o-X--E--B-----B-B?---X-
-------MEX--E?----M------o--B----XM--?----B-E---XM-------E--X--X----E----X-o-o-------M----M---------------M-----------E?-XX-EB-o---------?--oM-E-?--B-o--B--X-E---?---o---oM-----EB?MB-E?-?-X--------E--
-E---o--E--E-Eo---BMoo-------Eo--BX--MB----B----X-M-M-?-B----B---E----------M-B--X--X---X-??----M-E--oBX-----o-E-E-o--E------o--XX-----------B--BE---M-B-----o---E-?B--BE--X-XoX-X--BBo-M--M------M-----
--o--?M-X--o----X----X--B---BB------?------Eo---XoB-BM--oB-EEo----?-E-X-E-o---X------X-?---B?B----E-------E--?----M----------------B-E-o-E---E------B-----?--oXM--?B----B--EE--XB---o--------B--E-o-XM--
--MM------E-----X----X---X-E?BB--E-B-B-Mo-?-o----??-XMM?-E--o--o------XMM??X-o----?o-X-B?-----BX--E-E---E----?---E-E-o----oBBB?E-------?-----M-?---XB---X-EX--------E--E-M-----------o---M---X--MB--X---
----BM?-M-E---E---B---------?-?o---XE--?-E--XM---B----o-B----o-M--?-------oM-B-E------B--X?-?E-------E-----E---------?-X--?---?-----------XB-MX---?oE-M-o----X------oo-----M-----M?-------E----BXo------
--M----------?-----M-----M-M---B--oMB-----M---E-X-------o---X--o-o----X--?oo-XEM-M-------------o---o--o----E-M----oMX-o?-E-E----X-------?---?oE-?--MB-X-o--------M--------?----XE-----B-------B-B-X-----
--M---M-----EM----E-E--X----?--E-XE---X-?X----E------M------------o-----EB?o-X--------E--X----o--o------oB-M-X?-X--M----o-XEo--M------X-M-B--------------o---?--BE-M--BB--X----o--M??-?-X---o---------Bv
--E--XX---E--X?B-o----B-o---------o-M-----?--BB-B-----X-B----M?-B-o----------M--------------?---o---EXX-?-------?B--Eo---M--EB--o----------?---X---o------?---E--E---MB-E--o-?-o---------------EE----E-f
-B---E--X---BX-E-X---B-XB--o-o--XB----o-----B-E?-E--E-X---?---oXE-o-M----o----------------?------?--------M----?-EE-B-?----BB---o-BoX---EE----X--EX-B-E---X-E------BE--X----E----o-?----o?-?-B-XB------f
------B?--B--oE--o-?-X--X-----X------?E-E------o---?----XEM?M----?-B-?o-o-M-E-------M-o---E-------?----B-E--ME-----M--M---M---MEE----o-?----oM--?E--B--X--?-o-EE--?---?M?-----X--oX?-----B-?-M---------f
-B--XM---------o-X------B-B--------?oo---oE?-XEB--E----------BM--E-XB-oE-?---?----XE-X---oB-?M-------M-B-B----o---------B--o?---M-X---XB--B---XB---?-o-EoEM----------------X-ME--E------B------?----?-of
---B--M-M----BE-----B-----o---?-----X--E---E-------E--EEM-X----o--X-E---?------------?---?---X-X?M--EB----E-MX?B-M-?E-??-X-X?--EEX------B--X--MEo-?-B---E--o-XXo?X-M--?XM-oo-----E---M-X---B-?M---?---Xf
---------o--X----?----------?--X--------B----M----M-------?--X---------?BBX-XBM--------MMo--M---B--BX-------oB-o---Mo------o-B---o------?-Bo--E---------B-?-oE-?---BE-M?-X-----o-----MBB--B----?M------f
mBE-----M--o----o---?--B--MX--B--Xo-XB---E-?o---X-----?-----E-o?M--B--X-E--------M----------o--E---------MoMBX-o----E------X-o---?--B----B---B---?-o--X-?--E----EoB--o-?---E-----XM-E-?------B--B------X
X----E-X------E--?----B----MBB-B---?--B-EX---o--?------EX-----MM-M-------B-E---M-XE--oB-XEEB-?---XMME---M-M-E--B-------EBM--?EB-Xo----BME--o---X-o--?X-M-----BMo----M-E---------B-o--o-Mo--E---M----E-XX
