--M--X--------MX--?-------?EE---E--M---------X-M--?-E-B-?M-B---BE----B--o---X-----------?----XXM------X--EE--------oB--Eo--?-B-E------o?-?------X--?-?---E-M---------o-o-------E--EXE-E------E-BB--B-XB-
----EXE--E-o-X------E-M---E---BoMo-o-X??--M---X--Xo------o--BM-----X----o----BMo------oXEB-----B---------o-------M---XE------MXM-------o--------?---o---B----B--EE-------B--X---?-B---B--?-?--M--B--E---
---o-XM--------?oM--M----X-?E-EBXX----?--oB------o?-Eo-o-E-E-----B--XM---------E--oX--E--X-X-E--X--EMB---B-o-----X-?EB---B---o-----?----E-------E?-oB-X----XXBE----B---E---X-?-o------M-o--------X-?-M--
---o---B--M??--------?M---?----oB-M---XB-----E-MB---------X----?----B--?-X---X---Bo--XB-----B?oM---M---B---M-------------E------EEo?-XEE----X-M-E--Boo----M-o-----MMX---E----?-----E-B-X--------E-------
-----------B-?E-?---B-------B-o?--B-------o-----E---?-EEBX-XE---E---X-------------EM----oE-M-?B-o--o?M-o--X?o-M--X-X-oM-BM-X-E---B----------X---?X-------E--B---B---M--o---o-----?-----B---B---E-----?--
-EM-XBM----EBMoEB-?ME--------B----o-o---X--------X-?----oo-?-M---B--XE-----------M----XM-----E-E-X---o---X------o------------B---EB--?--?--M-??-E-----EX--------o-M-BB-----M------?-o---B---o--o----X---
-----M-X--X?-M-----o--M---E-M---M-B--------?MEX----------XEX--E-o---BX----B---o-o-B-----?-M---M---M------M----------M---B--o?--o--B---ooo-------B----X---?M-?-----X--?-o-------------o---BB---B----o----
----X--E---o-o--X------B--o---E--E-------B---??--X----?--o-E----EoX------B-B--o----------------EE-X-M-?------B---M----B-XXM--o----o-Eo------B-----X-E-B?--B---------Bo-----B-M-M--M-X?E----------M-----v
-M-BE--o-------------M----EM-----X-M?--X---E------o-?M------B-Xo-?--------o--X--o-B-?---B--------?------M---o-----BX--XXXBB------E---o------?oX---?----o---?o-BM-X-?------M-?--?----M--E---B----E---B--f
------o---?--??XM--X-M-oM---X-o-o---------MB--?X--------Xo----o-E-oM----o--X-----B------E------?-B----EB-B---X---------M-?-----B---o----?--B----BB--B--------X----------X--M-EM?----X--E---M-----------f
---------?ME---B-ME--X----B-?B-M-E------M?-?--?---E-----E-B--EM--?---X---------------E---X--E--BB---o-XMB-E--?--o-o---?--X-MM-B--------X-o----XEoX--E-oX---?BX------------E?--o-------X------X----?E---f
----o-------oM-B-X------M-B-------B-X--------o--X----B---oMo-X-?E---o-----------E--M---o----?o--EB-----------?---M----?----------E--------E-?MM?B---?----o-?-B-----M?---?------o--X-------XBE?X----?---f
-X---------EX---?-o-E----E------o-----------MB---------E----M--B----o-E--X-X-------XXX---o----B?-o-EB---EM-----?-------E-o-------B----??--------Bo-XM-------BB------M--X--M-----------B-X-XoM---o-X----f
---oX--oBB---B--o--B--?--Bo---B-E-------BX---MM?o--------------B---E--------------EXo-Xo----EX--EE-?--ME--XX----B-----------oM--o-------?--E-------E---M----o----B?--XM--EE----?-M----E---X-M--M----o--f
mEo?----?---E---Xo-------XB--T---o-----o--XX--?----E--To---XT-oE------B-o--E-------X---oB-?----E-XTB?--ooo--M-----E-B?---?-T--???------?---oEo----E-?--T----E-BBE--------oT-M-oE---EMX----T-?---B----BBX
XXE?XXBXBXXXXXXXXXXMXBXMBXXXM|XXoXBMXXXEX?MXBoBXXXBXXX|XXXXX|BEB?X?XXX?XoBXXXXXMBXXXXXXoXXMXoMXEXX|XM?XXXXXXXXXMXXXXMXEXXMX|XXXX?MXXXXBXoXXXMXXXXXMXXMX|EXXXXXM?EXoXXXXXMX|XXXXXXXBXXXXXXX|XEXXXXXXXXMXX
