X-o?E-E--------Bo-M-------E----E-M-----B--------oooXME--?---------MB-?-B---Bo--X--?MB---X?--oo------o---X-o------oo-BB-oX---------?--?-o---M--------B----Mo--M--XoEXX---BE--X-----M-----o--Eo--M--?---XT
-o-B---E--?--o----?--o--o---o-------?-B--BX--------E-o--E---Xo-X---------oX--------o-XMEo?-B---E---E--M--E---E?-------M--M-------------E----------EEB--E-M---?-E---------M-?------B-----X-E-E--E?-M--X--
EE---BX?X-------M---M----o-M----?---o--X--?E----?---M-XoX---?---?-------MEM---?--M--?-------X----o?---o-B--X-E----E---?--BXMM-MME----X-M----BEX-B-?--E-----------o--M-------X----M---B-o----X-oM------o?
|M--X--M--?B-XB-------X----o-B--?-?---o----------Xo--------------X---X----X-------Xo-o-M-X-M--o---E---X?---X-E----------BB----X--X---M--?--------M-----o---Eoo?-E-B-M----E----X--X---------M--------?X-E
X--?---X--B--?--BM-MoX-X---o--X---X--o----?X-----M--------B--MB----?-------------M--?BX-?------------M----------EM-B----ME--B-?--?-M--?-?-X------?M--M-X-o--------X---?oE?oB-BE-M-------o------o-X-B-E-o
M-X----B---?-------------MXEX-M?--E-E--X----------M----o-B--B?XXM-X------M---o?E--------X-o--X--o----EE---MX--XM---E-Eo----BX?X--X------?M??oX----Xo-X-M-------M-----M------------o--X--EMo-----oX--MoXB
X-?-----?----?MB-X--E-M---BXE---B-------EM-----E-X---X-E-------X-E---XM-X--MM-----?-X-E-B--B---------o--?------------M---X------X----B-B-------------ooo----?---E--EX-o-B---?-BXE----M-?--o?XX-?-B-----B
-----------------X------X-------oM-EMB-o--------EM-o---M--oE---BEBB-------B--B--XM-X-XB-----M---X--B-----E-----XE?---o--E--------B--------E-----o?-o--B-o-----BBB-----------------?----B?-----B----EMo-v
X--MM--X-M--B--?X---o---M---BEM----M--------E----X-o----X------B-o-M-EMB------B---o---MB?----o---X--------o-B-E?M-----?---M----E-E--?M------M---B-----M---Mo--o-------E--X------EB-oM---E--E----------oo
oo------XM----X--E-BX-M-M------------X------XB-----X-----o---B-E-XX---B----------B--X--BE-MB---XMB--------E--XE-X--X--M--BBB---o------EX---M--B------B-XX--X-----B------MBB-EB-B-??--E----E--o--E-----?M
o-B-----B---?E--B--------B----B---------o----X--o------M----------X--ME-------?-MM---M---oM------?----?XE-?-E------X-------?--B---X-----BMo-E-MoX-----?------E----XMM--?---X---?-B------------oX-o-E---o
-B--X-X------BM---Xo----M-B-----o------------B---------MEX--ME-B----M-?---o-o-BM------X--X-----E--?--?-----M-----Eo--?--oo-----------MM?--XB-----Xo?-o-------oo-B--X--------E-o---ME-?M--BX--M-B-X---E-T
T-----o-XE?X-----Mo-X-M-o--oX-M-?X------M-oo------?o----MB?-?---BooM-BEX-oEM-o--------oM-M------XEBB--E---EX-----XEo?-o-------E------B--------M----------X-M--------B--BX---E-----?-------o----o-------o
|-X---oXo---M------M-B--?------?--o-E-----------o-X-B-B---X-------M------XB-?----B------o---------Mo--E-o------MX----?XX------XB-E-M-ME-E---X-MB-?----o--B-o-----BBM--XM-------------o---------------?--
m--------------o---E-----E--?----o------------------o---B?--??-----Xo--?MME-----B-?X-----------?---?oM----M-E--?----o-EM------------B-B----------X---B?-B--------?---E-------------E-E---?-?----?-X---B|
XXBXXXXXXXXBXXXXXXoXXXXXXXBEXXEXEXXXXXEoXXXXX?BoXMXXEXXXXXXXXXXXXXBEMXXXXXBXXXXXXXXXBXBEXoXXXEXoXMoXXEEXBXEXoXXXXMXMXXXX?XXXXXXXXEX?XXXXX?E?XXXXXXXBoXXoXXoX?XMoXX?XXEXXXXXXXX?XXMXXXXMXoXEXXXEXXXXXMX?X
