---M--X--B-o--B---EEB-----Bo---X----o--M----?------o--B--B---oB--B-----M--X---------MEo----X---XoX--M---------------X---M-B-Bo-E----BB-----E----?X-EXBE-------o-o-M-E-----?--o-----??----B----BX--o-E---
-------------E---B-o-X---ME------?M------Xo-----?MX----E--BE--B--M---o-oB---B--B-o-----XM?X------Eo--M-oB---o-------E-----o-X--?----E---------oB---X-------B--BX----B-o--B-E-X-E-----M---B---EBB---B-EM-
----------?--?---EX-----?---B?B--?-??-o---?-B-?----B--M----?M-X----o----?o-X--?---?BEM--------------XB--BXXB-----------E---o--------oM--M---o--E----EB---E-M--EB?--o--------BE-?MX--o-----M----o-M?XXo--
-E---o-----------o?--Mo--?--E-E-?--B--o-X-M------B-E--o-X---E-X-o-XB?------X-?----E?--o--------E-B---BX-E-M---X-----E----------?------?M---------B----X-M----------EB----oo----------Bo--B-?-o-X-M------
---B-E---B-M-----o--------------BB----oBo-?---?--------o-----------------M-------M------o---?-----E--?-XX-B-EXo-Eo---X-------B---o----EBo--?o--B?-----o--E--X-o----o?o------?---?oo--?---?-B---X---X-M?-
---B--E---?M-E---X-E----Xo-MM-B-X-XM-----E---M----X---M--o-B---MX-B--E?E-?---o-B---M--M-X-B--EM-E-------X-B-----MM-B-X-EBX--MX------oMX--X---------E---B-----oB--B---M--B--E-----MM-BME--X--E-------o-B-
-X?-X-----------------E-----B------M----??----X??oo-----------o---M---M---?---?--o-?M-oB----XM---------E-EM-----o------B--BB---X-XoE-----------o----M----?---?EE--------------M?-M-oo-----------?-------
-o----B--?-X---?-----X--XoMB-----X----E-E------X-----oE?--B----------EB-M-M---------M--B---o--?MM---------------?---?---?o-?---EE---E--------B-?ME-o------XBEX-o---?M-?---X----EB--EM------XBM--X---o-ov
-o-X------B-E------X-o-Xo--?------M---X--MBM-E------o-M--XB-Eo--B--M-B--E-BoE-----XX-X--------?----EE-M-MBM---XXo--MoME----EB-----?-----------------B------B--?--E----oX-E---M-M-B-------M-M----oB----Xf
--?--------M------M---------oB--E--XMoo----------E-----E-------M------?o----E---MM----E-----------o-------Mo-B-----o---B--?MX-------BMM---?--o------BX?-E-------?-X---?EM?-XMMB-?--M--o---?----o--B----f
---ME--o----M-B-----o--B-?--M--EEM-------M-X-----------M--B?-o------B--oB--o---------?-----M-------M--M---------?o--B?-M--------o------X--o---BB---?-E--o-B---o-?E-B----?--M-------X-o-------X-?-B-oM--f
-??------B---?----?------X-----o--MXMM--EM--o--BB--X-X-------------?--M-E-M--E---XoME---------o---BX-BX--------M-------E-E------X-M-----M-?----?X----E-------?o---E-M----X-----X----X---E---E--X?------f
----M-----X--------B-??B---------E-E-?---M-?-?-B---X----?--XXo------o--BX---X---E?-M-B-Eo-?--E-----EM?-----X-M-------E---Bo--?-?--M-X-B-----------B------X-E---B------E--X?Bo-----?--E--?--Mo-?--X-----f
----?-----?o-X-EX---?---B--?X--E-B-B--M----B--?-?----------XM-oE--X-?--------E----E---E--ME---Mo------B--M----M----o-X-X---XB-X---E-----------------?X---E--B-?------X----M--X----MX-------E-o?---B?---f
mMTX-E-T------B?-------------B-E------To-MME-----?-B-M-MT-------BMo-o-?-o-M--?----------X-o-EE-B-M---?---?-----?-EXoE--M-T?-----T--X---XX--T-o-------?B------TX?X?----EE----XB?B-M?oTBo--BX-?-?BE-XE-M-X
XX|XXXX|XoEBXXXXXXBXXEMXXXEXXXoXXXMXoB|XXXMXXXXXXXXXXX?X|XXE?XXXXXXXXXo?XXXXXEXBXo?XXBXXMXXXXXXXXXXMXEXXMEX?XXEXXEEXXXXXM|XXXXX?|XXX?XEXXXX|XoXoXXXXXXXXXXXXX|XXXXMX?XX?X?MBX?BXBXEo|XEXXoXXXooXXXXXBBXX
