-?X-EB--XE-EMX?-?-M-EX?o?oEX-XMXXB-X-X-oXEo--BXEo--o-XB-XE-EBoEEMo-?EBEMoMB?-E-E-oEXX?B-B-X-oEM---XXEEEX-EX-Xo---XEE--XMX-?-B-M?BX--B-E--X?-XEMEE--B--?X-XEBMoo?-X--E-XXM---oX-XEB-X--X-o-o---XEX--B--E-
---MX-B-EX---B-Eo-X-XoX-o-E?B-oXE-BEoEEXBB?MoEE-X---XEo?EBMX-EXX-EoMXXEBMMX-EXXoXo-XXEooXM-E-XEEB-Bo-XBEoEoXXX-E-E-BME-EB?oE?E-Eo?E-E-XBE-o-BX-MXXE-E-E?-o-XXBME?Xo-EBX-BXX?-E--B??o--oMoE-X-M----EEEEB-
-X-o-?-o----E-E--EX---EXXBoMEEEooBX-BEMBB--B--oEXXEoEE---E?BEoX-?XEB-EB-E-XM--XXMEEXXB-ooXEEMBEX-EB?X-BXEE-oB--XXE-EoE?-X-EE??XEXXBEEME---EBE-MX--B-EXM--XEXXXMoMo-X-o-XEXoBXXEoM-M-XXXEM-X---BEXXEEX-E-
-Bo?-EB-ME-o??-o-ooMo?EXMoX-MB--EBBXX--?E-XEEEX-X-EB---B--MXXE--BBEXBXB---?ME-EBX-XE--B-EM-E---EXXBEo--EBXMXEX?B-X---?XEEEM?E--oE-?BMX-EXBX--X?XE-EBXEoB--ME--EX---E--?oEBoE--?EE?XoX--X-oBXEXEEEBX-XBo-
-BEM-oo?B--EMoE--X---MX?-BXEEBXXXEX-?-?X-ooMo---oX-BXXE-XB-oX-B-XMBoX-EMEEME-XE-XooBEXoXoX---EEXMBBEBX-o--XoBooE-XE?-?X-?M-E-E-E---XB?-XXBX?-B--ooE--o-MMB-E-XEo--XEX-?MXEX-XX-X-?-XX--E?E-XXEE--EEXEX?-
--BoXEoXB---?B-----EXo-M-MMXB-BXoE-B-XB-BEoEE--M?E?ooB-BM---oX-o-MX---XMM-XE--EoEo-XEBX-EoBX-BMXXX-EXoMB?----?MoE--X--o-XE--XXoBEE-B-EMX-o-oM-X--oEX-B-BMo-XoMXXoooXX-MEoME-X?--X-XX-BoMXMoX-BXEX---X-X-
-E----BX-E-EXo--XoXEMo-XX?XBXE--E-oEE?-E??XXXBEo?EXEEB-EEXXB?XXX---XX-X-X--E-B--XXX-E-EoE-B-XXE---oB---XEX--EM--oXEB-o--B-XXX-XXXEXBX-X--BB--BBXo--BXBX-?-E--BXo?XoE-XE-E-EM-XE-o?X--?EoXXE-M?BBX?XMXoB-
--EX-oBE-XXX--E?Eo--oBEBXEXoEB?-XX?BB--oM--EXXEBBX-B?Xo-X-EE-M-----EEMB-EE-X-XoXXBooEBX--XoBB?------E-B?XX-?MEXXEB-BMBX-EX---E-oE-oBEX-oXXo-EE-oXM?-EXME-E-oE-XE-B--XEEXBXEMEMXEE-X-XoXoBMEoEEXXBBE-oX-v
--EB?-?---EE-X----oXEoE--EXM--EXEEE-EXEB?-EMX-MX-oEEX-EE--M?oo--oooB-EB-X-MMBEXX?--X--X--o-X---X--XBXBoMoXM-ooEXE--EBEXXBoE-XoXE-XX--M-E--X-EXXo-o-EB----MX-MEXE--o-B-B-XMBE-EoE---XMBoXoEXEX-EX-X-EXEEf
-B-oE-XXo-X--X-BEo--XX-B-MEEXX-EEE--BX-B--X-BE-EBX---XoEEEXXX?-?Xo-EB-BE--M?X-oEEB-BEME-EB--B-BX-Bo-M-XEo?-?-BEooX-XXoo-oXM?M-EBXXXEE-MX-XEoEEXB-X-?--XE-EX-MXMM-MXB-BEM-XX-E?XXMEX-X-XEE-E-X?-EEBXoEMEf
--XBoM-X---oE--EMEX--B-Xo---M-oXBXEB--XXo-oME-M??XoEEXooBMXEE-E-EoEXE-X-XBME-EEBEXXo-?X?-EEEX--?-B-E--EMXXXB-BEXM-EXE?o?-BB--BEM-o-B-oEXXXoEEEXBB-X--BXEX?-Xo-oX-EXXBEE-EB?X-X-XXBM-E-E-MB-XXE--MoEEXEMf
-X-BXM-E---EE-XoXXXBEX-MB?---E-E-XXXXEBXXoX-XXXBEX--o-B-E-o---oB?EXX--o--M--EM-EX---o?EB?E-E-oooXEEE-X-o-XoXX-E---XMBX?EBEXE-M--BXEXEo?-XEX-EEX-----XoE---X--XEMoX--?XoEEE--X-BEXBo-EME-E-E--XBMoX-E-B-f
-X--EM-EEo--BXE-?E---E?X-X--B-EE-X-X-o?-X--MMXXoX--XX--EBEE-oXXX-E-o--E-o?-XBEBXX?EX-EX?EM?EEXE--o?-EE-XB--EXoXE?-EMB--?o-M?B--E--Bo-XE-M---E-EoXXXoE--XX-B-XEEEX?X-o?MEXBX-E-o-E-Xo--EXX-oo-XB--B-oBXEf
--EX-EX-EM-?-EEX?EE----BBBoBM-Xo---XEM?-XB---ME-EEXoXXEEBE--XB----E-oEEoX--oX?M--EXXoX--XE-EXo-XBE-XEM-o-ME?XXoXXBBE-M--EE-MEXB--MXE--oB-E?EEoE--X----BE----XE--E-XXEX-XEX-XXM-B?o--oX--BXB-X-oEX-BE-oXf
mX?XX-BXE-B-E-BB-EEBoE-XB-XB-EXX---EXXoBEMMXM?EEXoEXXM-X?X-B-o--E-M-X--XX--E-oXE-E?BX-o--X-EEEXXXEMXE-?--M----XB----Eo--oEX--?--BE-XXEX-X-oXEo-BX---??-XXXX-oE--oXBEE-MoMEEXXoXo?---E-XXBMM-oEEEEEXX---X
X----EE--BoEMX-BXME-E-Eo-BBX-XXXEXMM-XEo?-EEoEX-oo-XEBEoEEEo?ooXXME-E--oXXE?oXEX-XBBEE?E?X?E-?-oEEoEE--EoX--BXX?X--EB-X-X-XX-o---M--o?oXoEXX-E-X?-XX?E-EM---X?-X--BXXE--EXEXMEEMooE-oEBXEX--B--MB----MXX
