----o------o-------------B-B?-?--?-M--o----------X--?--X---MX?BB?-?--XM----XBB--EoBE---?oB-----XMM?--EoB-?B--B-?----X-----B?B------?-oM-----X---B?B-XX----M-----o-ME------M------------E-X-oXB-B-?MM-E--
--B---B-E-M--o-E-o--BX----E-M--MM-oB--?----o---oE-MX-o--B---------B?BM-B----M--E--o--o-----E---------E-----B---?----E---------------------o--B-B----X-----XE--X---B-------------o-E--oB---X------B---X--
-?----B--B?---X-----B--Bo-B-XE-----?----?-X--?-----M-o----M-oM----o-BXM-Xo--BE------X---?---?--o---E-M----M------M--XEo--B----?------X---Xo---X----EE----EE-oM----B------E-?------?-?XXE----Eo--B--B----
--X--M------EXX---?MBE------------X--E--X-X-EM-----M-------X---?----B---------M-------o-------?-M-X-E-o--M-?M-?----?-o--oM----?------?----------X------B-M-----?-----------B--------------M-----------?-
-----o-o?o-o------?--E-X--B-?E--MB-----E--M-B-X-o----o-E-o?-------M---?-------X----X---E-----------?X------EB-----?E-------X--M----B--M----oE----------M-----------B-EX-E---oB-o---B------X--X?-----E---
----M------MM--X-----o-----MB--M---B--------------EE-------M-------E-B------M-X--o-o-M-E-BM-oMB-B----MX-o-EMX---XM---E------E-------------M--B-oB-----B---MX-X-M-E-----E--M----E-BE--o---o---EM-------?-
--?ME------B-M------B-----E-----E-B---XE--XE---X-?---------M-----oM------MX-o---E-------?--M---M--MX--B-M-B---M---B?X-----BB-M-------------Bo-X---B--M?------o-MX-o----B?---MX--------?E-X-o-----XBo----
------M-ME--X-EX-?-o---BB-M?--E--------o-B----------------BE--E----?M-M?XEB--------o--------?---E--o--B----BE-E-X-----------------------M-MoB----M------EM-XBX---oMM-X---M----o-ME----Bo-----M-?--E----v
-o?--Bo-?-------B-o-X---B--M?-----XM----o--M--E-EX-----X--?----------?---X----EX---X-?X--?BE---------?--o--BEBX--oB?Mo-----M--B-X-------?o---------XB-XB--o-B-M---E--------MXB---E--------------------Ef
-E----o---------E-E--M-BB---X--B-oX---o--B-M?B-BMo------E----E---?----E----o------------X-?---B-B-------M?---------o---X--Mo-XE-----BE-EX---B--E---E-M-E---?----------------X?--E----------?---E-------f
--oM-----M------X---o-M----X--?---B--X------M--?--B------o-------EXoMM??E-----?--X----------?-------o-?-XoM-B-E-o-----------M-E?---M-E----X-?-E----E-XB-XM----ME------ooB?M-o-----?M---------oB---B----f
-EMMo-X-B-BoB----Xo----------oEB--------E-X----?---XM--XBX-B---oE-----E----X--Eo------BX-----------Mo------M--?-------B---o-?--Xo---X----E--o--E-?-----BB-----oo---X----E--?-----EB-------o-B---B-EE---f
---MM-E---X-?oEX--B---B---BM-?-----------E-X--?-----E------oo--?---------?--?--EB-o----X----E-E---E-BB---?--X?-----M-E-X-----o----X----M--o-------X-X----oMBE-XX--oEMBB--M--E--o-E---M-------M---M---X-f
--M----?--oX---------M-M--BM---E-B----?------?-o--Eo--?o--B-XX-E?B-M--------------?-----X-B----o-X---Xo---o---------o--E?-?-------X-----------X?-----E----------X--o-M----E---E-o-M?M---o---XB?X----?o-f
m?--o-X?o-T-EB---Mo----E-o---BMB----------E---B-oBTT---M-------M-T?E-B-?----E---M-TT-----B--?---T-B-------?-------T--B?o-E------M?BE-o-oBTB--B---o--B-B----------------oME-o------B-oM-B??T--X-?---?TE-X
X?XXXXXXoX|oXXXXXoXXXXXMXBoXXXXXoXXXXXBXMXXEXMoXEM||?oXXXXXXXXEX?|XEXXXBXXEXXXoBXX||XXBXXXoXX?XX|MXEXBoXXXXXXXXEXX|XXXEXBXXXXXEXXXXMXEXXX|XoXBXXXXXBXMXXX?BXXXXXXoEXXEMoX?EXoXMoXXXMXXMXXX|XXXXXXXXX|XoX
