------XXo-Eo--o--?-E--EoE-XX--oBEEo---E?oEE---XXBXXEEB-XX-MMoBXBM-M--X--EXXEE??M?EoE--o--XoEE--BBX?X-X-B-?E?BoBEXX---oo?X-Xo--XB--E?-M--X-?X-X-EXXXE-XEX--X?-E----XB-X-EBM-o-XBX?-?-B?--XBEM-EEX-E?-X---
-B-o---XE-EE--BBEoEE-EMBE-XEBoXEXXEEoEB--MX--o?Eo-EX?Eo-Bo-XX-XooM-EBXEBBo-X-o-M?XXXEXEE--XXXXBBE-o-o?XE-o-oEEXB-oB-EBEXMXXXXXX-oE--E-EM-XBXXBM-EBEBX--E-Eo--EXB-EB?EXXBBEB?MBEoE-EBBEBE--X-BXX--XB-XXE-
-?XMEX-?--X-XEEoB-oX-X-XX?XXEEBMBMooXM-EEBEBMXX-ME?-E-EBX---B--BXE--BM-E?oEEoXo-XMEEB----Eo-E----XooXXB-E-EE-B--XEX-EXEo-E-E?oo--EE-BXooo-EE-X-EEXXME-X--EM-E--oEXXEEX?XXoB-XXEoB?--X-oEX-E-B-X---Xo--X-
-BXE---Eo-EoE?-BEBXX-XEoBX---EoEB-BXX--BMXoEM--E-XEEX--EXBXEMB-oX--EEB-EooXEE?Eo-X----XEE?-XBEXX?EE-BXXE-Eo-oE-X-EE?o-BE-ooX-?BB--XM?E-?-E-E--E-X-XBX-X-XE-E?-EEX----o-BoMXo-oXMoEXoB-BX--XB-oEM-B?X-E?-
---XEMEXE-E-EXXEX---o---M?X-BXE-XMEM-BE--B-XE--E?MEM?XEX--XMXB-EEEX-BXE-B-BEoXXEEE---XEEBBBEXE--XB-Eo--EBEEXX-ME??M--EB-o--MXo--X-EMEX--oEE?o-BE?XE-E?E-XEEE---o-?o-XXoX--XoEo-EEE--B--MoX-EEXME--XoX?--
-?-BBBEo-?oB-MB-X-o-XEXo---E--XMX-BEB-MBXE-EXBooMEXE-E-Mo---X-EMX--B-E?E-BX-XB-EEoEE?oE--EXBX-M--BEXoME?EXo-E?XoEoM-E-B?XM-B--E-BEXMoBE--EEB--X---Xo---EXXE-XX---X-XMX-X-XoEM-o-XXXoEX-E-E-oMX--X-BEE-X-
-X-?X--o-oMEBEXM?oE-oX?XoEM-X--XE-E-XX??oEXo-EEMX-oo-M-E?o-E--oEE-EEBX-E-EX-BEXE-B-?BX?BBEXXB--?M-EBXX?XB---XB-BEEoMoBEBEX-XEXoX?M-ooEo-EEo-B-XX-X-BEEX----XXX?XoXXB-XB-XMM-XXo-X?EoEXE--?MX?-B?XXE--Xo-
--EEo-BEE?E?XoEoB-o?o-EXo---XoMoBXB?XoBE-oEBX-EX?Xo-XX---o-XX--ooBEXEEXoEEBM-E-XE-EE--?-XXXE-E-E?-X-EBEX-?Eo?X---EE---B-o-XE--?o--EEM?BXEBo-XE--XBoEEoE-XM?-MEX-X-B---E-M?EE----XM-EEEo-EEE?oEoEBEEo-MEv
-oE--X--?X--E-EoXME-BE-o-XXEB-MEE-XE-o-?Xo-EB-----E-EBEoEMB-?-XE-Bo-EBEEBoEXoBXB-o--?EEEM-?XE-E-XE-X?XE--X-XBEo-EE--o?oEo?o-EXXX-XBXBE-XEo-BE??o----XX-MXEX--EXBXEBoB-?--X?-XXXo--EoBMoE--EXEXXBM?-EBEMf
-Eo-B-o-X----XEEMXEMEM--Eo-M-oE-BoE-B--oX-oX-E?EE--XXMEXM-EEE-XoM--XEXEXXX-Eoo-E-EXBoX-E-XXEoo-E-M--EXE-XBXo-ooo???--B--EBXEo-EE-MX-oB--X-X-E-E-EEX-E?-BE?-oX--E-EX-EXXE-XXo-E?BoBBEMBXB-E-oXXXM--EBEM-f
-EX-M-XoM-----XBM--X-?EX---Eo?EoX--BBXXXM-BoB?BEXBXEBXEX-XXXXB-oXX-o--o-oEXEXXXXXBXB-E-E?MXo-B-EBoXo--EE-M-XE?XEEo-X---o-EoEEo?MEoEBE----E-XE-?-ooE---E-BX?-XXoX-EEM----XE-oo-E?XEEXEo-MoEE-E-Mo-EMMo-Ef
-EEEoMEXX---E--ooXXX-XBEE-E-oE?oXXBBM-BEoX-E-X-EX-o-XBXX-o-EXo?-XXEo?E---?E?MX-EE-BEM--X--BXEE-E-E---MEX--EEEEE-EXoBEEo-X-?---?XXo--?B-M--Xo---X?EE-?----B?XBXEX-oMBo-XX----X---?BXXEX-EXo-BEEoBXoB-?XBf
-E-X-X?BE-B-EXBXBMoM-XXE-?-X?-M-EEE-EM?X-EXEBXXE-X-o-MX?BXoEEBBB-XMXB-oE-BEoE-?X?oEM-EMXXXoMBX?--E-XEoME-EEX-XMXXXME--EXXo-B--EEBEoEM-M--EBXEXEEX-XXEo?E--EB--o-oXEXXXE--o-?M?XEXX--EE-MEX-ooX-BoE-?X--f
--B?-o-EMEXE-EBEB-XEX--BBXBo--X--oXXo-X?-E-E-EXoBEMMX?-Eo-XXEEB-E-BMo-o-B-EE--X-XEXXE-ooEE-oE-oX-o?BX--X-Bo-X--?XoBX-X-?B-EE?XXB-X?XXX-oEE--XE---oE-E--XoXE-EMBBM-M-EEBBXoB-XX-X-BBMXoo--E-E-XE-MX---E-f
mEB-B?Xo-??EEEE-MBEX-oXX-Xo-X-----M-EBXoEBM?X-MEE-EXoooBM-EEMXoB-EX-X---?XBXX--XM-XBX-XXoBE?-EoE-oXXE-X-B?E-?EBoBX---o-E?--?B--X-Bo-oBE-X-EBoXBX-XE--EMEE--EEMBEX-?Xo-EX?XX--X-M-X-EB-?XEE-E-o-?BB-o--oX
XE?oB-X--XX--EXoXX---XXEE----oXX-ME-oB--oX--M--EXBE-oXXXo-oo-BMEEX-Eo--MBXo-EE-XB-XEE-M-?B--EEX--MBo---BX-BBBME-EX?XXEoXMoEX--E-X-BXo--BB-----?-BE-M--EEEo--XBEXoEXoo-EMoXEoXMo-X-EBEEX-XoEE?E?X-X--M?-X
