B------------------------------------------------------------------------------------------------------------------------------------------------------------------------------------------------------X
E------------------------------------------------------------------------------------------------------------------------------------------------------------------------------------------------------T
T------------------------------------------------------------------------------------------------------------------------------------------------------------------------------------------------------T
E------------------------------------------------------------------------------------------------------------------------------------------------------------------------------------------------------?
B-------------------------------------------------------------------------------------------------------------------------------------------------------------------------------------------------------
E------------------------------------------------------------------------------------------------------------------------------------------------------------------------------------------------------?
-------------------------------------------------------------------------------------------------------------------------------------------------------------------------------------------------------o
T------------------------------------------------------------------------------------------------------------------------------------------------------------------------------------------------------v
To-oMX-------------??--oM----B-------E--------?-------??----E-E--B------M-ME--o---oM-E--X-----?--X----BE--M-X--?---B------M?Bo---M----X-o----XMo-M------?-BE------------?-X--E---M-----EX-----------B?-?
|-E-?---M--BMo-??---M--X-E---o-o---X----B-?-M-?---o----M------o-ooB---B--E--EE--E-o-oE-B-oM----X------Bo-o------B------E-----XX-------------E--MB--?E-----BM-X-----?--EE---------B-Bo---o--E-E-o----?--E
M-o---E----B-X-X---o-----o----o-----XM--BB---E---E-X-M----M?----------?--?------X------o--o--?--?-------?B---E-XMB?-o-------E--X-----Bo------M----o----------o-?-M--?M----------B---M-oB-M---------oXXM|
B--X---B--E--B?------------?--?---?----X-BEM----X---?---?------B---o--X------M--o--BXM-M-------X-----X---M-------BX--B-------MB--?M--B-E-------E--Xo--E----X-X-X----o--?-E-----BX-X---E-----E---E-oM---?
M-M?-EB---------MB-EM--B---X-Mo-?BX----BX-----B----o--X-X?E---------X--E-X------------X--E--o-----?-B-M--?B-------E?B--E---EM--?-B-?-X--o-X-B-?E---o--B-B?------M-----o-E--?--BB--Eo------o----X---M-M-M
|-E--E--M--MB--o-------M--------o----M-----E------B?-X--M?MB------X-BM-X--E---?--B--XXE-?----E?BXB-M-------o---------B--X---EE-EX-----X------------BM---BM--BE--o----o--?XBo------o----X-----oEX---X---o
m-----o---o-----o-X--oB-?-MoXo--E-----------o-o--oo--oBX---E--X----?----------------BE??---EB--oB-oE--?----------B-o-X------------?---M-MM-?X-?-----M?----E---------o-?X--X-?M---o---E---o?Bo---EEE----M
X-E--------EB?--------B--------X---XE-M-o--BB-M--?--E-?-o-B--o-----B-X--X-X-o?--o---M--MB----Eo-E--M----?X-o------X--E-M-----MM-o------------M---------?-B----------X-----X-o----B-E--X---o-----------XX
