B------------------------------------------------------------------------------------------------------------------------------------------------------------------------------------------------------X
E------------------------------------------------------------------------------------------------------------------------------------------------------------------------------------------------------T
T------------------------------------------------------------------------------------------------------------------------------------------------------------------------------------------------------T
E------------------------------------------------------------------------------------------------------------------------------------------------------------------------------------------------------?
B-------------------------------------------------------------------------------------------------------------------------------------------------------------------------------------------------------
E------------------------------------------------------------------------------------------------------------------------------------------------------------------------------------------------------?
-------------------------------------------------------------------------------------------------------------------------------------------------------------------------------------------------------o
T------------------------------------------------------------------------------------------------------------------------------------------------------------------------------------------------------v
T-X-B-----X-EMo-----?-?-----M------?----------E-X-XM?-?---B-X---?X-MM-EoM--M-----o--o-ME-E-M---E------E-M?-X---X-----------M---E--?---?-B-------M?----?-----?MM---?---B-M--oM-E--oo--?--M-----------?--?
|o----B-?-M--------BX--B-oE-Xo---EXX---X----E--------E-----E---?B--XB?-oXX-o-E--M---EXMB-M------E-E--?EX-----------X----XM-E-----E---E-----?--?---------o-----X----??-??-----oM--ooBM-EoB---B---------oE
M---E-EMB-XM--o---M----XEX-E-X------M-?MX-M--M-----M--B-B-E---M--M-o--X-E--B------o-M---X----ME-----B-XE---M-----X-?---B-------------?--oX------oB-MM-M-X--XB-X---M-E--E-ME-X--ME---X--M?-XB----------o|
B--?-X--M--EE--E--X-----X-B---B------EE------??B----?----M----X-B?----E------B--M---BBBXM-----XM------X-------o--?--M--M?-----X-Bo--?-----?-o-o-?-----BX--B--M----?-EM-----Eo---MB-M--EEXB--MMX?MoX----?
MB-M-?X---M------M?o-E-----E--?-o--BB--EXE-o-B----E----------B-X-------X------X-E-------X-?------o---------o-----------?-----------E----M---E-------?----B-B--EEMoo-----------?-----Bo------o--X------?M
|---o--o------E-B--X---o-EX--?-------o------?-?--?XX-o-X--EMB--?--X--------------M---B-?o---o-------M-?-----?-o--B------Bo--o-------E-?--o---E-M---EXB-----------------E--o---B--oB--X-Xo-X----?---M---o
mX-o-E?-----EEo---EoE--M--M------X-B---------MoBX----M-------------MX---EB-Xo-M---M-E--o-X-M-----?---?-MM---------M-----X?--M?oX?MM?--E-----MX-?-M--XMEB-BE---EEBE--E-?-----B-?---M---E--?-E?--BBE-----M
X--M-o?---B---EX?M----o----o--?-?-M------?---?-oB---M-?-X---B-E----?-E----B-----?-X-----------?---M---X-?X-?-M------M-----EB------o-----?--M----?-B-----oB--MME?--M---------?E----XM----M------E-------X
