X---M--B--o---------o--o----B--??-o----X-------------M---EM-----B-??oE---------------E------X-?---M--o-M------XXX-ooEXXB----Xo----o-X-E----------------M-------B--BM--X------o----E---E------o-B---M-MET
-o-EM-?----------oXM---------BB-X-------M?----B------X-oE-----?-----------?-------E-o-E-o-------Eoo-E-o--oM---B---E-?EX--M--X---E-------------?E---------M--E-----B--E------B---Eo-X--?E--M---oME---?E--
E-?----B---M--------E-B--?B--B-X----------E-----?-?o------MBEB?----M------B-----?----?-M?M-o?----B?--E----B-------B-X--B---ooMX-EE-------------?---EB-----?-o----M---X-M-----------BM----X-E-----------?
|M-----o---------M-??oXE-?--?M-M?-o---?------------BX---E-----o--Mo--EX--?B--------M-?----BX----M---------o--XM--??-B--E-M--X-------B--E------BEM?----BX?o---E-------E--------M-E-M--o?--E--B----?---o-E
X---M--B-------Bo-----?---M--?--?E-----X-X----oE--XMB-----M?---E------E-------E------B-----B-o-M---EBB-o--oo-?-M-o-----M-o-M------o------E--------B-E-------------------o-----?X-?-o-E---E----------?-Bo
M----o-B----?M?----X-oE-B--E?E------oM-----XB----o-M------X-XB-----o---X---o------X----Mo-?---BB----EB-M-E--------X-E----??--MEo-------oEo--B----XX--------?Eo--oX---BXX---oMo-----?--E---B----?-------B
X---E-o-E-X-o---XX------E--M----o----o----B-M-----ME-XE----------M-o-------?-M-------M--X--XEo-------M-------M-BB----M---?XB-?-B-E-M?----??--E-Mo--o---?--X-?-E---------M--M-B-------oX----------?--o--B
---B-M--?B-----------E--EX-E--?-o----E---ME-B--?o----E-MME--E----o-----MEM----E-E----X-M-----oB-E-o?---o---XX--?o---?o-----M--?----?E-X-------E--E-B--M------BE-----X--X-E---E----M?------B-----X-X----v
X------E--?--BEMXM-------------M--E---B--?-XM?o--B--E-B---B--E--B--------M----o-EX-------M-----?--E--E-o------B---?X---M-o-------o---E--??-?----B--E---M----X---?-----XB-Moo---X-M-----------EX---o-X--o
oo-Xo-o?---X----------------------------?-----X-----MX--XB-E--E--XE-oBo----E-o-----------?-M---M----------X-ooo--B-E------M---o-?-XX-X-----M-?----XX---?---?----M--B--X--M----------X-----o---XE-X--oB-M
o--?--B--------E-o-M-------?--B---------X?oo-----oM-----------M-----------------M------E-----?-----o--B------M------BX-X-M----B-----o--X--?B----?-X--E-----XMo---M---?---o---BE-----o---E--E---------o-o
-Bo---M-B-X-----M---o?---X---?--X-?--------E-XE--?-X-?----B---XM-oM-M------B-----------X?------BB----XB--o-X-E----------X---Mo--------MEX?M-------B-o-M-?------------MM-B--M--M----E--M------B-----X-?-T
T------------M---------M-E-X--o-------------o-----------B-------?---B----o----------?B?-M-o---B-M---B?---X--MB------------------B?-------X-------E--?---MX-MXE------------EE-B-----M----MB---ME--BM----o
|?-M-?X--B--------------M-Xo-o-E-----?X?--o-----B-------------?--o------X-o----M-----X--X----X-E-------?-?----o-X-?----XoE-------?o-M---B-E-BMo--B-XBE---X-----M--E---X--o-X--M---o---X--?-M--M----B----
m------o----o--X---------M-X-o--?----M-oX-EM?X----B------B-X-o-XEX-------E---X--E-B----B-?oo---?--B-?B?--oXX--B-?--?-------o-----o----E-?-E------o----M----E----o------o-B-B--X-X-----BMX---B-E--XEo-?M|
XXXEXBoXXXBXXXXXMXXXXoXXXXXXXMX?XXXX?XXXXXXXXEXXX?XXXXXMXXXXMXXXXXoMXXoXEXXXXXXXXXXXXXXXXXXXXXXoBXXEBM?XMXMXMBXXXoX?XXMXXEXXXXXMXXMXo?XXXBXXXXXXXXMEXXXoXXXXXXMXXEEXXXX?XXXEXBBXXXXXXXXoXMXXXBXXEXXXXXXX
