---EX-EBXXM-?X?-Xo--B?-o--E---o-oo-M-XE---M--E-?B?-XE?EEEXo-M-X-EEX-XBo-EX-oMMX-E-EE-Xo-M?X-E-X-oX-X-E---B-Eo-Mo-?X-BB?XB-?-X-B-oX--B-X?--EBBEo-Xo-oEoXXEXE-EBXB?EEEMEE-EB---BE-XXE-EXXEX-BX-EoEoXE--XE-
-EBE-?M-E-EME-XE--BXXX-Eo-oMX?---B-BEME-XXEX--BXE?M------XB-o-M--BoXXB-XX--X-XBB-X-X-EEEXXo-BXEB--X-oM?E-B-E--XME---E?XXXM-o-oB-EEXXEoEXBXB-XEoM---BX-BoooX--XX-E--EM-BoXEBo--BE--XE---o?BXE-XEo-EXMo-E-
-BXE--MEEo-Xo-XE?-XE-EoM?--EMMEE---XXXB-XX--E---MEMB-EEBX-XoB?EE-XEXB-E--XE?oE-----E-B--B-BMEX---E-o?E-X-X-XXEE-oB--XB-X------E--E-BMoX-X-BEEX?-EEXX--o-E--E-B-XBEE-M-Bo??EXMX-EEXX-EXX-BX-oEXB?-Eo-ooX-
---ME-oE---MB---EXXXX-X?EXEX-X-?-X-X-EM?--o-X?oE-EXEoB--XXEMXXoXEXE-?-?--BBEXX--?X-oMEoEBXE--XB-oEXEXX?MM--oE-XXXMEoB---X-oo-BM-MEo-?-X---??X--M---oMoX-X-o-E-X?B-E-EEM-XB-B-o-EXMo-EE-MB?EEEE-E--X--XE-
-EX-EXM--XBXXXEMEo-BEo-X-X-EB-ooXEoEoE-BX?XMX?E--EBEEoXEoX-oE-M---EBXE--XEBoMME?EEXXXBoX-EXE-E-o---o-oMXXE---o-XXBo---?oE-BX-?-Eo--XEoBB-XX---o-?X-EoEEB-B-XE-oE-XEXMEEX?XE-o-EEoE?-EEMEE-E-X-B-EXEo-?E-
-Eo--B-EoX--XXEM-o-o-XX-EE-oo-BX-X--XoX-XB-EX-MoXX---?EEMXX-B---EXX-XXEEEMXEEME-EX-E-BE-XX---BMX?E-ME?X-XEMX--MEoo-o--E?E-o-XB?X-oXEEEE-?BEEEXE?oX---E-XEE-?XE-M--X--XoX-XX-E-E-oE-XBoX--?-Xo-EoM?EX--X-
-BXEXMXXBX--oBoE--BB?-oEMEE-X-oB----XE-EEX-XEMX?o---EXXBXEXB-X-oEBoX-oo-EME-EooXEo-?ME-XEEE-?X-ME-X-E-B--EXMEEBXoXEMEXXoXB--XX-EBME-oEXX?-oXEMBXXEXX--oE--oo-EEBX-MEX-XEEXE?X-BEE?oXE?E---XB--B--BE-----
-E-XXB-XEXXXoBMBMXEXMXEM--?X-B-E--M-X-oB-EoE-X?XEME-M-X-oX---MBoB---Bo--B-EXB?EoB-X--MEEXE---E-XEXB-EX---?BE--EE-E---BB--X---?X-X-XoBXM--EM?-BBXBE-?--?-B-X-EoXME--BMoX-oEoXoBEEE--X-----XXo--o-EXMEX--v
-EEoX?E-E----XoM---EXEMM-BEX?EE-o--BB--BX?--MXE----EE--M-EXoo--BEXE--MBoMXM--o-oBXo-XX-ooX-E-?EooEE?-BE---oXBX--XBE-Mo----MB-B-Eo-EXXM---BEE-BBB-X-XBX-?oB--XXE-oBXB--E-EoEB-MEEoB-XBooMoX--EB--BB-XEXMf
-BB?EE--XBB-B-M----EEEE--XXXX-MXEEXB--o--X---o-EE-X?EMEE----EXo-oEoX-EEoEEXX-X-EB-M-BB-E----B--X--XoEBE-EEEEEM-EEB--EBo--XBo--XX-EEX-oEEEXXM--XXXB??----oEXoBEEo-XE--XX-EoXB-?E-EEo-XBB--EEM-oXoEXE---Ef
-XEEX-?EXoEMEXE-EX--BEoM?-MX-E-B--?-B-oXE-EEEXEB-XE-EE-X?EM-XEXX-?oXEMBBooEo-----Mo-E--BEX-M-EXEEXX-BB-o--E---Eo-XX--EM-XoMBMXX-X-E-?BB-XE--E-o-BBXXoXMX-Eo--X---?BEEBBMo-EoEE-EEo-o-E-E--XXEX-M-?XoB-Bf
-o---o-oEBM?XEoBXoBo-?-MX--EXB--EE-oMXEoX-o-XXE-X-MMEE-ooEE-oBXX?E-EXX-XE--X-oMEB-oXooEo?E-?EXEo-E---X-EM-ME-E-XE--EXX--M-BoXM-EB-B-X-?--B-EMo---X-oXB---oXE--ooXoX-------B-?EB?B?XXooM-E--XBEXX--o-EXBf
--XXE-XX?B-X---XXEE-?--XE---EXBEXE--X-o-B--E-oMX-XB-EX-EXXB-XXo--X--X?X-?BXoXo?XXo-XXE-BE--oXBEXX-oB-XBMEE?EBBEXM-?oEE?XE-EEBXoEo-EMEE-EBoXXoE-BBEME-o-EoEXBX?B--MX--EBoEEXoE-EoEoM?E-oX-??-XB-B-BB-o-Ef
--MEXX---EXEX----?B-o-EEBEXX-E--B-B-oE--XEBEM--B-EEX--XX--oM--XXX--X--E-B-oBXBB--EEoX-B?-----?E-EEBBooXEBXM--?EXE-EB-?---XEE-BBXoXoX--MXB-o-E--oBX-XXEXXXBEMMMXoXEXoo-Xo?X---oX-XB-o-EEXEX-XBoBXBEXoXoXf
mooBXEX-M-X-oBXM?-EX-B-BBX-E-X-XEX-o-EEXE?EBE?BMo---EEMEX-oXX?XEB-ME--BX-EE----o--?E-oEXo-MEMXBoXXXB---B----?--BXE-?EX--EBXXE-o?E--BEX?--E-XMoM-MEEE?E---XEXB-BB-E-E-E-EX---XEEX-EoEX-EE--EXooEoXEEM--XX
XM--oo-XE-BM-XE--BXX-M-E----X-XMEX--ME?oEEEE-EX?BXE-X--oXEoEEE-E--oo-EoX?-X-E-XoXBoEE--X-B?MX-o?--BE--XE-X-X-BEooo--EBX-EoBEEXE-X-XoXE-XE-XXX-?XXEEoE-oo--XB--EEoE-o-Eooo-?B-?--XXo-E-EEMBBEX-?---XBo-XX
