---?-EX-B-X-----?-----E-----E-----M-?---B-X------o-----E----E--?---X--B--B-o-M-M--BB--M--oMX-B-------X--E----MM-?M-----Xo-B-o----MEBo--M---X----?--X--B--B-M---E-o----EE--?B--E---oB--E----oX-B--?--Mo--
-M-oo--E-------o------?--E-E-E-M---X-B?Mo----BXX--BB--?-o?---BM-----X------o-------X----------------B-E--B---B-o---o---EM-oX----------E-MM--o-----X?M-?XB-B------oX--?--BX--?---oo-X---XM--X--M---B--M--
--------?------Bo-E-B-M-----BXo-?-----M----EX-E-EE-?M-BEE-??-E-?--XX--XE-B---B-X--ME---M--M-o-EM--B-oM--EE-E-E-Xo----M--B-X-X----E------B-XM-------B------XX--M?--X?-E--E-B---X----B?---E------X-X------
--------MM--------BBB-----------o-o-?---?--M--M--M------B--Xo--EB---X-----B-XE--?--M-------o-----?------M---B?---M----M-XE?--E--M-----?EM----MXE--ME-----o-B-E-EoX-------M?X---X---E-----?M-?X-o?----EB-
-BE-X-BoB------B----oE--BBM---------X-----?-----oo--oB------E?---------Eo--X---Eo--o-----M----------X---Xo--XE----EE-M--M-Xo?------MB-XM-E-o-?---X---EX---?X---o---Xo-------E---M--M-------?----E-B--?--
--M----M---X---B----XXM--------E----?--o---o-oB------E-M--BM?---E--------XE----M---?XooB--o-----Bo---?-X-X-XB-?X-o-M?-BXB---M---B-BM--MBXo--oM-----o-o--o--B----?---------M------X---MX-E--XB-X-----E-B-
---M----??--X-?B-o---E?-o------o-?o---------------oM-X-B---E---??-----Eo-B-------?------oXM-o--X??E-o-EB-X---o--?--BX--?X-------?-----oMMMM-?-M?B-------o-B--MBXM--------XE-B-------?M?-----B-M------E--
-X-----------X?-X-B-----------M---M------o-BXM---o--?--o-E-o--B---M-B-MX----E---X-E----------------B---o---o--BB--M-?EE----------M--M---B---o----------oMX---Bo---o------?--X--M---M--B-E-----?---?----v
---o-EE----------XE-M-----M----?----X------?--?--o----B-----?------?-M----?-X-------X---BM------------E?----EE-?---------------M----o-o-?---X----M?oE------E--?o--?---o-o---?---o-E-o----M-E----oX-MB--f
---------MX-B-X----?o----X------o--M-B---E-X-----B-------X-E----?E?------E----M----Bo----Eo----B----E?----BM-?E-------?----?--------------?-B-B-X--?B---------?---o?-MoB-----B--------------Mo--M-----of
--?-E--BX-M-----?------o-----M-Bo--Bo--o-XE---E--XE?-o-X?-B---?M--o--E--M-----M-----B----?------o---XXM---o----ME--M------X-E---E-----X---X?-o--?--B--------MM--XM----B----EB---X----M------B--B---XoB?f
---X-B-BE--?-----o--B-------M-----------?-----X---B-M---oXB----E-oXE-----oM--o-----B-----M-------?----Xo------------o?E-?-MX-?-X--MX?-B---X---E-M---MX-----X--?EB------E--B--------oo-----MX--Bo---E---f
--MM--M?---o----B--M-Xo-E?M-E-MBX-----E-----------X------------o-----Bo---o-----?------?X---------oB--o?------E--X-----MME-M------X--E------XM----B---X?-------M--BM-Eo----?-M--B-B---Bo-o-XM------M--Xf
--o---oB-M--------o----E-?E--X?-----M--X-B-B----X--B-X-Mo--oo--XM----E-o-EBX--B-M-----o-M--------B?-B--o--?o------X-BB-B------------B-X---EX-B--B---B--BM---?-------BB-?E------------?-E---X---X-M-B---f
m---o-X-X--B--------X?-MM--X-------X--M----?M-E----M---?-E-----oX-X---------X----ooEB-o-EE----X--B----M---XM-B-?-X-------E---oM-o---M--oo-E---E----EB--XB-Xo---------------M-ME----------o-E?------E-B-X
XBXXXEXXXXXEXMXXEXXXoX?XXXXBXoX?XXoXXXX?MXXXXXEXXXXEEoXXX?XXXXXXXXXXXXX?XXXXXXXXMEXMXXMoBXXoXXXXXXXXXXXXXXMMXXXMXXXXMXXXE??XXXXoXXXXXXXXXoBXXXEEBXEXXXXXXXXMXXXXMXMXXXXEXoXXXMXXXXBXXXX??XXXXXXEXXXBXXXX
