-XoM-o---Mo-X-o---E----o-Xo--------X------------E-E--?--X-o?--Xo-Xo-X-------------E-------MB-------XB---?-XX--BM-----------------?--o-X-----MB-?-?-?E-----B---------X---Mo-----B----?---??---B--??--oX--
-o-----------M-E-BEM--------o---?----M--------M---------o?------M-----o-M----?-B----o----?E-------Mo----Xo-M?EEB--B--E---oE-------E-X-E--?-----?---------------------------M----oM---oE-?-B----o----B---
-B----EB------?oE--B--X?-M---XX---M-----XMB--M---X-XX---?-MM---o----oB-----X-----?----Xo-oE--M----------o---M----o---------E------E-E--EoE?--B------B-----Eo-B-----M--B--X-B-?-X-E--ME---------M-M------
-XE---M-------E--o---------B--X-E-E--E----------EB----M--XM-?---------X??----------EEM----EM---Eo---o------M---o-X--?M-?-o-B-------o-B---EX---X-E-------B--?o-E-X----o-----X-B-o-B-BB------o-------oB---
--E-----X-?--B-?-------M--M--B-M--Mo-----M-----M-E?-------B-B-BB?-----M---------E-----?---?X----------------E?--E?-ME---?--EBBX-----X?--o-M--?-BoXB----B--E--?-E---X--B-?-----BM-XE------X-----B--------
-B?-?-B-o---X--o?XXX--M---------M-??o-MM-M----Mo--o-M-M-------M--o-X-----------o--oB--X?---E--?o---X----E?-----M--?---E----E---B----E----??o---ooE-MX--M----X-------B-------E-MB?------o-E---------E----
-?-o-------------M-BEo-M-------?XoE------E--M--------B---M-o-------o----M---E-E---oB-E---E-X----E-----oB??E---B-----?---------X-o-E-XE--o-EoM-------o------X----E------ME-M?-o---?----E---M-E---oX------
--?--M--M---EMX---E-B-X--E--?-M-B----X---oX-X-E-----------?-E---E---?-------B-X?M-B---o---------------------?-B-----o--M--E-------M?----B--E---?--?X--o-M------X-----X-------o------E------BX?EE-------v
--o----M--o------M--Eo----------oEo-------?M--B-??o--Eo--X----?-E-?--------M-o--?B------?EXEE---------?-----M---------?----Xo-----E--o-----?M----M---------o---------------M----?----?--oMB-oB--BoM----f
-----B--E-------o----B--B------E------?--XM----M--------B--?BM--EoM----E----?M-?E?--BB-o--?------E---E----------o---X---Xo--B--o---BM-o--E?-B?X---B-----?X-o-E------E-?-MM---EX--M-?---X----o-----E----f
---M---o---E------B----------X---B-?-----o?----?-------------oM-B---X-B----X-----M?-?---------o--o---MXM--?M-M--X--?-------?----EBEEX-----E-----E--?-E-X-B-----?-?-?E-?-BB-----B-?---E--X-----o--X-?--of
--o--XX-----X--?---M-o-E----o------?--?-----MMM--E-E---X------M----?EE---B-E------?B-----?--B?---?-E-------X-EX--E??B----B-------?------X--------M?------??--?---B-----o---ME---B--o---E-MXo-------?---f
--oo-X--------o----?----E--o-------B--M--B------E-X---M--E--Mo-??---E-----B----o---M-o-o-E?-X-B---------E--o-?X---E--?B--E---oEM----M-X----?----E----ME-X---XE----BX-?--------oMM-E---M----B-----?--BM-f
-----B-E--M------M----?----B--XMXE-----------E?X-EX---o---M-E--E-B----M--o-----Bo-----X-------E-Xo--X--?-E--M--ME-----B----o--M-------------?---------?---ME?---o---BB--X--?--M---X-X-o--ME--X-?M-EEB--f
m-X-o--X---T--T-E------Xo--T--T----T--M----ET-Mo---X--MTM-XoT-?---o---------E-B----------X----oM---?-MXXM---X----o-X---B---EM----M---EEo-?----MEM-E--T-oT------XB-o--T----MBE-E--X--MM---M---o--MX--?-?X
XXEoXXXBXXE|XX|XXXXXXXXXXBX|XX|XMXX|XXXoXXXX|XXEX?XXX?M|?BXX|XoXXX?BoXEoXXXXMXEXXMXBXXMXoXXBXXXXXBXXXXXXX?BXX?XXXMMoXXo?XX??XEXXXXXXXBM?MXXBXXXXXXXBX|XX|XBXMMXXXXX?E|XXoX?XX?MXXXXXXXMXXXXXBMXXXXXXXXXX
