-----EoB?-M-?---Mo-?E-Bo----oBBXX-EX----MEo----?---X?B--M--?-X-X-o-BoXoEBB---BM?MB---E-X--oB---B--o?----B???-X?-?--??E------E-XBo-X-?B--------B--oXB--?-E?ooX-Bo-E-EE--?--E-XXXM---B-XM----XEoM---o--E--
------o-M--B-o----Eo-oE?-X-MXo-Xo-----X-B--BBEB-o-M--E-M--BX?-B-M?o---MEME?X---XX-EB-o-ooooBo-M-X---X-B----X-M?--E--E----Eo--XEX-E---------EB--BM-BB-o-MBoBBX--X---XX--o--B?E-B--X---B-o-----XB-B-oE----
--------o--E-?EXE-o--BBoo----oBEX-E?BE-X--E---M-X----M?E-?-E-XX-B--E?B------E--X-X-?XX--?--B---X-MEE-o-B-BXX?-?--BE--Bo-?-MEX--o?oXo---o-EBE--Xo-o-?----B---BM-BX---BE--MBMB-E--E?oEX----B?X?--oMXX--oB-
--M---o--XXo--X-o-X-----XXE--X--B-o-?-EX--XEoX-------X?X----BBX?-----BEo--oB--E-X--B----B-EM-E-X-?---M--?---E--------EX-?B?-o-BEE-X-B-EE--BBoBooX-B?M-M--BX-X--E--M?BM-B--o-X-B-Xo-Bo--X-XBoXB--o--?----
---MX-XEEE-oEM-B---M-X------Xoo--M--X----ooEXBB-o---XX----X---oo-----XB-XXE---?--o-BBMXB--EBXooE-M------o-o-oX-oXBo---o-?--M-X?B--EEoME-B-Mo--Xoo-?M?EBX---Eo-Eo-E-?-E?E-?X?oE---XBM--BoME---EE---E-X-X-
--E--X--E-ooBEo-oE-B--Xo------BB-MB-EMXXX--XB-MX?-X-XX----o-M-EX---B?----XoX?-----EXX------Xoo---oX-???-M---oMoB-X---?--o-E--X-----?--E?MB-EM-Xo--BM--?-?---E---?E-Xo-B--X-EoB--o--B-E--MXo-BoE-?B---?B-
-X-oX--XE-E-EBEE---MEM-X--?--E-B-B-o--M--o-X--M-MX?X-B?-----o-E-EoBE--E----MoEo----X-M----Mo-B-oXX-o-MXE----?-EX------o-----BB--X?oEXMXX-------o------XB-X------?EXo-B?-BEEBEM----XoMEXMoB-E-----EEo-oM-
-X---M?--EX---B-BX-------o---XB-EB?----------o--EB--E-o--B-E-o--E--XoXo--oXXEB-M----oXEB?--MBM--Mo----B-----XoM?oX-EBX---?oX-E??--o?X-B-?-B-EE-----X-X-o-EBo--oMX---o--MEX-Eo?EB-B----XM--XXBXE--X--B--v
-o-B-Xo-X-M--?-o?------E--MBXE--Xo-EBMBo--BB-BBXo?-oo--oEo?-?-BB--o--EB?-X-XE---oXMM-o--XoEXoX-EBo-o--oX--E--?-X---XE----o-E-XoB---o---B----o-E--o--BX-EX-Xoo---BB-X--?B---XBB-MBXXX-EXXXE?-o--X--B?-X-f
-XX?-B-o---?-E--X-----B--X--------oE-?------BE---X-----o--o--EM--M-oB?-?-oBo-M------MX?BX-XB----B-XoEB----X-oXBMB--?B-MMME-Eo-oB-BEMBXB-M---B-?----EoM---E--?-E-BM--ooEMX---EB--?BX--BM-oX-o-XBB----oXBf
--E-XB--MB--o?--BXooo-X-E-XB----B-----o-----E-BMX-X-XE---B---oo-E-oEo-oEX-oEo---B?XX-XMo-----?MXoo-M--o---B-X?MMX-----------BX--o-E--MoX---XE---BE---oME-oBXo-?ooo-X-B--EoB---Mo----E-o-?-B-o-X-E-X-o-Ef
-B--o---B--o-X-M--E-B-EoE--o-E-?X-M--XoBXE-?-?E--M-oX-oXE--X--?--M-oo---E--o?-?-XEX-E-oXB-BE-o--E-----XME-B-ME-ME--Xo-BEE----Xo--oo----?--X?-EX---B-B---?B-----M--XoEo-EMXoMB---E---BX---B--X-EBX----?-f
-?--BBXX--o--?---E-oE?o-EM-----EM---EX-----B-B-M---o-MB--o--M-B--E--E------X--?E-EEo-oE?---B-XB-M-MX-B-?BoBEXM--X-M-XE---o?-M-----B-XM-X-B-B--?X-EBX-BX-?-BBoBXX--?EMBEX-X-?-BBE?-Eo-EB-BoB--B-EE--?-B-f
---X--?---XE-?EEE-X-?----oX--oEBo-Xo-?EEoX-B---E--M-BX-X-X?-EXB-X-?M------EE---E---MEoX---oo-ME---EX--B--EXBEXMX-E-EB---?-ME-?-o--EoEoE-o----XM-B---BEX---Eo-B-X?EXX--?-o-B-E-XE-BE-MBoBBXX-B---EEB---Xf
m-o-E-E--EX-E---X-E-?E-XX-XoE-BX-XX-o--XEB--BBX-MBB-o---EX--oX-o--?B----?oE-B-----B?-MoBB--oX-?XooEM---X-?X--XE-------E-BB-MB-M----EXXEBB-?-EM-??---?--B-E-o---?--X-X-MX-----X--M-?-----oEo--XE---?-o--X
X-M-XoE--Bo-X---?--oEM--Mo-oEoo-X-o-EEoME---E--oBo--?BEo-B---X---------Eo--XXB-X-?-o--XXX---XB-BoB-M--?Bo-M-E-EM-?-----------XMB-EB-?-BX--EX-B-B-oE---EBo?-BXEXE---E-M--X?oBB-BX-XE--X--Eo?-oB-?Eo-?ME-X
