X---E-M---o---------ME----------Xo-XX----B-M--o----M-E--------MXX--M-X---BM-M-E---M--------?--?Moo----M--------X-MBoo-?---M--o-----M?--M---------------B??B-----E---E--E--E--XX----M----?E--MMo-o---o--T
-E-X------?------E----ME--M------M-----o--XB-------o-o------?X--------------E-X--X----------------Eo-E---X--?--B------oX------o---?E-B----------B----?--X-X?M-?X----o-------M-Boo-E--B---o-o--------M---
E-?--EB--E-oB---?-----MMB--BB-B-B-o---B--?-E-E----X-E-----?-ME?-XBB-----MXB----E--B-XB-M------X-E-------o----M-----X---B-B--BE--B-o---B--M----?E-----------?B-E----E----------o---?o?EM----o--M?--o--M-?
|----E----oB------B---M--X-B---E-------Xo-------M---E-------------X-E------MM-?-----?-o------MEM---E?o---X----B-E?--B---?-X------BE------------E------XB--E--?--BE----X-B-?-oB--o-M--X-----B--M-M-o--?oE
X------B--?--E----M-?-----M-o-E------XM---E-M-o-E-Mo----------------E-?--E-o--B-----M--X--M-MMoBBEX-M----??-E-?-E----?B--X--Xo---o-------X--M?---E--M--o--X-----EM-?--M-E------??--E--o-EE-B--MoE--?-B-o
M--BB---------------o?E----X-----------MB----B--MEoX-------BXBM-----o----E-----X-o----M---X------X---o--E-E-----o-?-E---MM--o--XB--?o-B-?---M-----o-E---BoB---oX-M--B-XX---?---XM-X---------?-Xo--B-?--B
X--?----oBX--------B-?-oX-?E-XX----------E---M-BMo-MB--E-----EB----------X---------E-E--M--o-----E--XXoE-M?o-B-E----?----------?----------M?-EX--M-----o-------E-oX-X-------?--B----------MX--B------E-B
------------------------M--o--M-----E---X----M--M--------------E---------BM---EB--MXX---?B--?MM----oB--B---MXBEX--E------M-X--------XB--o--X------E----------Eo?-------------M--X---M-X--X----M-E--M---v
X?-o?-??o----X-o------M--B---B-EX--?------?B--EXBX?E-oE-------?-----XM-M---M--E?o-?--B---X----o--MX-B-----?B----o--E--M--EooM-E-------M---X-M-M--E?-M---o--?----------MB---------X-X-oo----M?-?--M----oo
o--X---X----XE---oBMM--E-E-----E---B-M--?--o--B--o--X-?-----M?---X----?M------BM------ooBEB--X--X-----Eo--X------o---------X---M?X---M-o--M-o--EXE---X-E--B-M-M-M-oE--Eoo----X---?------?Eo-----BB-o---M
o-------------XE--o??EX--?MoX----B---?-X-X--?B---X-B--o?E----B--M-?---?---------E-B-----?o?o--X----Xo--B----E-E----o--o-E--oo-B--B----------o-E-BB---?-XX-BE-X-o-o------XBo--------------------B-?-B---o
---M-E-----X----ooM-o?--E-----o?--o-EM-EMo--------------------oM---X------oE-XB-o-EM-E---X----------------Mo-----E---X---?-------E--B-B--B----B--M-B--X-----?--oX?X-M-o---oEB-----M-?X-----X-EE--oMMX-?T
TM-----o-E---o------E---EM--E-X--------X--------B--X--X?---M-M-X-BX-BX--X-E---o-?---B-----B--M--------M-M--X-------X----EE-X---M-??E----M-E--E-------B-?---E------B--------------X-?------MoM---B---E--o
|-X-----?---B------o---?---?---?M---o-----------M-----E----E--?-M-B--?M--B-------------M--E---o------------oB?-------o----o----------------MX-BB------B--------?E-M-------XE-----B--------?oM-B-BE------
m--------------E--?--B---?--E?--MMB--o-o-X--o--X?-----oE-----M-B---o?----M---??---X--B-?M----Xo----X--o----MX-----E------MB--o--B-B-B---E-M-o--?-M--B----X-----M-Eo----M-?-B--ME--o-----------?E-BB----|
XoXXXXXXMXXXXXXXXEoXXXXXXXMXMMXXXXXXXXXXXXXXXXXEXXEoXXXXXXXX??XXXXXXXXXBXXXXXXXXXXXXoXXXXXXEXXXXXXXXXXBXXXXXX?XXB?oXXX?XXMBoXXXXBoXXXXEXXEMXXXXXoXXXXXoXXXoXBBXXXXBXXMXXXXXXXXXXMoXXE?XXMXBXEXEXXXXXXXXX
