-XoXXE-?B-XB--o-XXME-?o--?-E?---Xo?XEE-EB?EooX-BM-XX-X--MXo-X-M---Xo-XXX-MoBE---E-Xo-?o-oMX-?-B?BEo-oX?X-o-----oo-EXEoE?MEEE-EM?BX--XoEX-X---?MM-o-E--XMXX-o-XX??----oMEXoXBX-o-XBo-EXM-EEX--BEXXoBX-Bo-
-XoBXX?EBoEXXXXBB------EX-X--XB-oE-E-EX-EE--EEX-EXXXXo-oBXB-XEooEEBE-EXXX-?M-o-E--EX-E--X-XXB?E--BoXMEEXM-EX-E-B---EBo-XX?BEXEooEBE--ME--B-Eo-oEEMXX-E?---oME-MXEEM-XBE-XoE-XEXX-ooM--oX-E-B-MXXXEX-XX--
-E-EEBooEM-----X-E--?-XEE?X-E-o-o?XoX-BXXMBE?-Eo?Xo?-BoBB--oE--o-BX-E-o---EBoXB-XEEEXXXEXBE-oE-----B-BXX-?EEE-M-BEEB-E-EBo-X-o?M-E-EoXMX-BMM-XEE-oBX-o-Eo-XEBBBX-ooEBB--oEE--XEoo-EBX-o-X-oXBX-oB--ooX--
-EX---?-?EEEX-XE--B-oXX---o-ooX?M-?XEE?--E--X-E?-BXB-BE-B-oX-EoX?X-X--E-EM-M--X-X--X-EEXE--MM?--EBXXE-?X--BE-XE-BB-EB??EXEE--oXX---MBXMo-X?-X--MEBBEEoo-EBBM-XX-X-?-?--XXX-oMEBXX-ME-oEX-EX-XX----MX?---
--XEBEX-X-E-XEXEME--oBoXE-EB?E-?EE-oo?--BE-oE-X----EBX-X--ME??---MB--o--B-EoM--MXME-E-MX-?M-X?MXXEEEXXXEEXBE-E-?-M-Bo?E-E-EX--E---EX?BB?XM-EE??XXXBE-X--BoX-BEBEXXE--XEXXE-X-XBEXoo----EM-XXo---EB---?--
-oE-MX-BB?Eo-BoE--MXXMXB-EXBBoE--E--BEME-?XEX-B-MX--X--BB--X--BXB-E-oE??X-BMBXXE-X--X-XXEoX-E-M-oEE?o-EEoB-oE-Xo-B-oo-?EEXE---X-Xo-o-M-Xo--X-Eo--X-XMXXoX--oB--Xo----E-BMBB-E?-oXEX-X--E?XXXXEE-E--ME-X-
-?--X---X-BXE--X-EoXXXXBEoEB--X-XXB?-E-o-X-?oEE?-XXo-E--Bo-???EoBB-ME-E?---BB?XX-EMME--XM---oBBE-BoEEX-E--EX-oBXX?M?BMMEoXEX--XB--EBMB-BMEEEXoEo-BX-X--oM--EEE?EoEEoXMXBXE-XX--XEE-E--oEBEB-oXM-X-XXXBX-
---E-X-E?-?BB--EEEX---XE?o--EX-E-X-X-XE?-EMoEXXBEXMBoXEX-----Bo-XX-XX-o-ooo--XXX-XoEo??--X?BE?-EEXo-X-E-EBBX?EB---?-E-XMEEEEBE---X-X?Xo-Mo?--EE-B-XoE?-XE-XEB-XXXE?E-EM-M-BX-----MEX-BXEE-oXoEEEE-?X---v
-E-MXM-o---XEE-B--?X?EX--EXE-X-X-BBXMo-EB--M-B-XE---?XEBBo-X-oXXo?EXo--XMEoBEoMMEEM-EMX-BE?--EBXM-XooEXE-BM--B-BooM?BEBE-EM?MEEEE--EE---?MXEE-EXX-?EoXoXX-E-E?EBMX--E-XMoE-ooEEXBXXEE?E-oEo-E-?-EE-XXoMf
-EEE-oEME-XEEX--E--X-MX-oXB-EXEM---M-MXXXEEoMEXXXE-ME-BMMXEX?EX-E--XXo-B-o-XoX-XXXoX-ME--BEMXX-EEX?BXM-X--E--oX-EXBoE-oXBX-Bo?XB-oX-X?E-BE-Eo-MoEEoE-XXE--EXEBoXX-o----X?EEEE--?E----o-XX-EM-E-BBX-BE-Xf
-?X-XEMo-EEEXXEB?-XB-X-BM----Xo-XBEXXE?-BB-E-E-EXXXMEEX-o-oE--EE-E-X--Xo-?-XEEM--M--E-BBX---?E-X?BoBXE-ooBEX-EEXXXX-o-E--BX?-?-ME-XXE--X-?B-?Eo--XEX-BX?X-XXE-EoXXXooE-X?-?oEBo-EBX-XXBEXMoo-E----o-X-Bf
-oo-o--Bo--MEEXXE--MB-X????EEEBM-B-o-oEMBM-?-XM-X-oXE?XE-EoXEB-M-E-?-EEE-o--X--X--oEMB-EXE---XE-Xo-X-X-XEX-EoXM-EBo---XM--ooXXXoEEEo-BoB--BXXX--M---XE?oEo?-MX-X---E--EEoE--XoE?-EXEoX---B-EoE-X-X--o-Xf
-Eo-M-oXXE?MEoo?EXBoEX---EXMBB-Mo-Bo-E--E-oEBoEEoBXBEX-X-EXXE-BE--EBE-Eo?EB-XXXXM--o--BXXE--EE-X?X-oEoE----EM?E--X-oXoXM-BXBEBEB-oo---EBBB-XXB-BEX--E?X-XB-oXMEEBEE?oXX-EX--X---X-EBoEBX-EX-E-o--BM-oEXf
-EEEEEEX-BBE-XEoMBE-XE?E-E-MEXE-o-XEE-EBEX----XXEoE-X-E-BBoXEEoX?---EE-B-EX?EoXXEEB---XMo--BXEXBXEE-EoB-BME--oooXM-X-MBBoBE-BEXXBoM-EMEXM-EEEXXXEXEXEX-EXEo-E?--BEEX-XX-EXB-?E--XE-o-E-o-EBXEoXBMB?-EB-f
mBBo-X-Eo--MooE?XXB?o-oEXoXoX--XE-XXE--EEX-oBX-MBoEo-X-BE-EE---E-E-oE-Bo-M?Eoo--X-oM-Eo-EEE?EE--MMoEoB-B-oX-B-E-EMX-XM---EX?E---X?-XXE-X---o-XXEBXoE?XXXEX-XE---Bo----E---BEX---E--EX------MX--X?EMBEooX
XEX--E--BXEX-EoEEooEEBXX?XE?-X-EME-E---Xoo?Eo-oBXBEo-XB?o-XX---oEEEE-E-o-B?XoBMXM-BXX-oX-EXo-M-EBEXE-oB--X?oEX?oEXo?-o-MX-EBE----?-X-?BX--XoEXo--BBM-XBB-E--B-XXEMMXXEBB---XE-B-Xoo-M--BEB-XEEM---E--EXX
