-EE-EoEE----EXBBE?-EEX?XX-oEEB-EEEoM-oMXXMXoBXXXX-EXXX-E-MMEoMX--EXM---X-X--BBE-E?B-MEEo-MEooo--X-E--X--BEXX-M--B-B?-o-EEEXo?X----E?MEBEoE-EM--XE--XE-XEXXEE-EBEXE---X?XM?M-MXE-X-M---E-BE-EE-BX--B---o-
--X-X---BX-XB-X-XEE--EBB--E-BEMXEEoEEEB--MoEX-oBXX?-XoXEBE-BXX---B---M-BBX-Eo-XX--X--XoE-E---M-M---BB-oB--E-X?-BBME---Mo--XXBX?oMXMEBEEoE--BE---Mo-B?-X--X?oMo-BMB--o--B-XBE?BEoEEEEBXE-?E-X-o-XB-EXBBB-
--EM-X----MoE-E?B-M-XoBoEE-M?-oM-X-oBB-X-oXE-EXXXo?-EEBE-EoEME-XB-Bo?oX-oEBoXXBEEoBEMEE-EBEBEEEX-E-BXoM-EE-B?-BBBX--E-?-oE-XE-X-XBXBM----XBEoE-XBEMX-oE-MX--X---XB---BoXoEoo-BEEEBoM-EEX-E--EX---BEoBX--
-XXXX-oBEEE?-X--EMEXM-X-XEBo?MEEo-BE-MXo--XoMEEEX-o-BXEXEXEXX---EEXB-oE-XEE--o-X-Mo-BBXE-E--XE-Eo??X-E-E-X-o-oXXX-MEXB---EE?X-X-BBoX-XME---X--MX--EEEXBX-X-oBXEMBEBo--ooo--E?oEBXoEBXX-oE-X--MBM-XX?EBo-
-?oBoXMEE--EMoMBBXEEooMXB-XB--E?oXXE-oX-EBE?E--E----E---M----X-Mo-XXEo--XoEEEM--EBE--oo--XXoEEoMXXE-XoEEo-BEXEXo--ooX-?-oEX-?X-oXEEo--E-X-X--EEBBB-EXB-M?-oMBoo?XBBXE--EBEEBEB-X---BXo?XEEB-B-o-MEE-XXX-
-B-B-EM??EBX?XX---BXXX?EMX----E-X-ME-E-ooXX--XXE-XEXXX-B-XoXoX-BEXEXEo-E-?-X---o--E--EM-X?oE-oM--oEo??oE??oXoBo--E?-?M-EEEM--X-Eo?oo-XXEEEX-EEo-BX-XEo----X-XXEoX-X-?E-EE-E--oMXX-XE-EE-XXXE-BB?E-EoBEo-
--?EEBEE??EE?XB-oEXX-E-EoX--EBBo--EE-M---o?M?--?XB-XEXX-BMoME-B--B-Xo-MEXE--E-XXBEXEB?-EEEX-oXEX?XE-?MXXEooE-XBoE--?E-EEoo--o--oX-BMEMo?X?XBBXEXE---E?EXEXo-X-XBoXB-EE-EEXoXEB-?BXB-E-EBBo-XX--o-EEBMBE-
-BE?XE-XoXo-X-BX-E--BME-BoXB?X-E----XXXE----BE-B-E-oMXE--E?-EXE-BE-Eoo-X-EoBoXo--XE-E-E-M-EXo-XB-EEX-E?oBX-BXXXE-XXXBoBoE?-MBXXXE?Moo---oXXX-EoE---BEX-XX----X-o-MX-EMEBBoBB---X-E-EE-XEEo-Xo?X-E?E-BMEv
-X-MoX-E-EBM-XB-BBME---X-X--EBX--X-X-BX-XE-XoXBEE-EBEXoE-XEBoX--oXXMo-EEBoBB----X-E--EooEEEXB-oEEBEEBX--X-o--oE-XXE-BBXE---XXB-EoXBEX?-EX-X-XEX--X-EE--o-EMMXXEMX-oo--MEoXXEMEE--BEo?-E--?XEEoE-X-BEEMXf
-EE--X--o-ME-E???-M--Bo--XoXBX-MM-E?EX-?-o-o--Xoo-EE-?M-?XB--X--EB-X-ME-X--BMB--EXBE--EoXBE?BEEXXM-oE?-M--X-XE---EBX-E-EEo-BMo-oo-BE--X---BoEoXXEEBEo---EM--BE--E-XM--oooBo?EEEEMEEXXEB?MX-EEX--?EEEM-?f
-oBo-BEo-X--o--MMXEB-X?-XEE--XXXXB----X---BBME-EoEE-BXB-o-oEXMooX--oX-E-MXE--Mo--MM-E-oMXoXB--EE-EEXEX?B-o--EEEBo-XB-EE-E--?oMX-oXBBB--MXE-BXEB-XX-oEEoE-EEo-EXX-XE--?--E-EoXXEEBo?-M-EM------XEX--X?-Xf
-X-BXX-XBoXX--XoEoBXEo?-Eo-B??X-oX-EEB--BEEB-BBoM-X-ME-o-?XXEo?EX?XoE-X--BEE?o----o-XM--B--BB--B-X-MoXEXEMMMo-E-XEBXEM-E-?--EEBEBB?--X-o------o-XMooXXXoXX--MX--XoXBE---XXoEB---?EE--BX-EEEoXXo-XX-XXX-f
-E?XXXEE-E-X-XX-o-EE--E?MXE-oX--EXXX-oXX-X?-BB?BX-B?E-EBEXX--oXEE-XB--Xo-BE-B-?-X-o--E----EBMMMEE?-E--BX-o-X--E--?-oo--EBXE-X?EBE--EBX-XX?--BE-oBEE---EoXMXB-M--B-oEEE--X-oBEoXEEX-EEXX-BXoXXX--X-oEE?Xf
-E-o-?ME-EB-oE--E--EE-Mo--EXEXXBoX-BXoX?-XB--M-XEBE--XEEBEXXE-EEB-EX---Eo?B-EE-M--M--XEX--ooE-EEBXE?BX-?E--MXXoB-ooXoXo-BoMX-EBoXXE-MEE-EooXBBB-XEMXEEE--X-E--EE--oXo--BXEM-XEEXX?-EMEoEEXB--EX--o--B-Ef
m---X?BM-X?MEB--BE---XEM-X-X--E?XEXE--XX-EX?XBXXEXXX-ooE-X-E-B-E-B-oXBEEXBEXXEEE?-B--?EEB-?-EB--M-o-EE-------B-EE?EXXEM?--B-XMX-XE--BEoXEMX?EEXoE-XX-?-EB-E-XEXX-XEoEXEXB--XBXoB?oEXME--MBE-o-EB-EMXM-BX
X-XE--E---?Eo-BoEEEEBEEEEB-EBoo?-oXE-XE-XE---M-XEX-?EXBXMB?E?XEE-o--XXoX--X-EEB-oEX-EXXXM--EBB-?-E-EB-EX-XBXEoEEB--X-X-XBBEo-?EXBBBX--XX-oEXEo-E-oB--EEBEEE-?--BX-X--ME-B-X?oX---X-ooEXo-BXX-Eoo--oXEEEX
