--BX-?o-B-BME?oB-oo-XB-X-EXXBoEMBB-o---XEE-o-E----E-BEEoXB--BoXX---?BMoXE-M-XEXX-EB?oB--E---E--EMM-X-BE?EEBBXoXX-EEBo--oEXXoXEoo---oEEX-XoE--B--XX--o-XMEX-XXXB-EX--ooE---?X--X-XE--BBX?-XM-o---?B-E-Xo-
-E-B?E-BoE-oME----BE?XBEXMXEX?--oX--BM-o?X?XEEBEEMME-E--BBXoMEE-X-EoX-B--E-BB-E-oX-MEE-?E-E-oX-BE--X-XX?EE-?oXEXEB--X-MX-B?XXo?BE-Xo--XEEX--XB-B-?Bo--XB-EXEMX-EEMEX-XE-X-B-XM--XEEX--?Eo-BB--EXX-----X-
---E--BBBXEBXo--o--Eo-BE--X-X-XE-XE-BE?M-X-E-ooXMB--EE-E-MXoXEEE?-X--XX-XEo--oEo-X-BXEoBM--EoXBX?-M-BXMXEoEXo-EX-E--XXoX?XXEEX-B-XB??EXoXXoEX-E--XBX---MEBXo-?--Moo-X-X?X-o-oXBBB-XXXB--B--E-EoXB-M-----
-E--EB-BX-----?-XBooBoX--MMB-M-?E-E?BBX-Xo----EB-?X--XE--XX-BEo--BX-XoMEBX-EoE-MoEoBBX-X-EE?-E-EMEBEE--B-o-?-MB?oX-X--EE----?-EEE-E--XMEoEMEXX-X-oBB--o-XoBoB--o--X-EEEXEoEBB-?BXXEEX-X?-EoBXoX-X--XEoB-
-BXX-E-EB-BEXE--X?X-XBB-XB-EEXEXBXo-XB--oXoXMX--BXE-EM----E-EoXEEB---MEXEo-E------X-oo?-?X-X-oX?E-E-MEXM-E?EXo--BBXEMXEEBX?X-M-MBBo-XBEXEXE--oX-E--BXE-X--ooEE-X?E?X--E-E--EM?X--oXE-M-EE-XXXEXBXB---M--
-BX-E---Mo--E??--E-XXM-B-X-E--EEX---XE-oEXX-XXXEXEBEo--EMBBEE-XX-BEoXEBXMMoEMXB-MB-XEB-MMEo?MBB-X--ME----X-E---?B?EM?oE--?----X?XEE-oE-oXB-EBXXX-XX--MBXM--X?E---o---XXXXM-B-XoX-EooB?-M-XBB-oXBEBBoXEE-
-?EBEEXEoE--EBMXE-?-MX---EX--?BEBEXEEo?EE-Eo--BB-oXo?EBE-MoEBXB--M?BE-?-E-oM-EM?oM-B?oXEXE-B-EoX-XXE?BX-E--BXE-ME-BE--XE-?-XEXoEo---XX?BX?EBEMEB-E-XB--X?XE-EBBEEo--ooX-B--Eo-oX---ME---E-BXBEoXo-BB?XM-
-E-M-?M-M-EXXXoBEBBE-??Bo?-BBXXM-EX?oXXXXXXo-EEE-----Eo?-E-BEoEEo-EX---MX?X-Eo-E-oB-X?oX-X-E-B-E-oXEEEXEB--M-BE?-EMBoo-?oXXE-oXoB--X-E?---EE--B-EE--X-EX?BEE?-EE-Xo-?oEXX-?----o--XoXo-EoMoEX--E-XXX--Ev
-E-MB-EEo-XXXo---M?EXX-oXXo-E--BEo---XE?XB-EEE-X-E-EXo?EE-X-B-XE--E-XoEEEEBEM?XMX---X?BX-oEoXM-MEXB-XX--M-M--XoEBX-EEEM--E?Eo-BoEoBXoB-BB---EXXE-XXXE-EMoXBE-Eo-BoEXoB-XEB--XE-?EEEXoo-oE--X-XB----MXBXf
-XE-BEoX-XX-E-B-XBXX--X---BBX--B-B-XE--XoEEoEEEXEoXXEooXoMo-?--B-EE-E-?-o-XoX--XXE---M-X?BMEXE--o-o?-E?--XXXoEBB-Eo-MXoo--XE-o--E-EMXBoBo--EEoEX-XXXB-B?Xo-XM-BX-?--XX-oXX-EEX-oM-EBBE-oEEoEMMEEB---EE-f
-EX--XBX-XoX-M?--X--XEBo-?-BXX-X-XE--EE??Xo-BEEEXEXXo--XXBE-XEE---X--oX--o-XXB-XXo-M-?EXEB--BEo-E-oE?EX--BXEX---X-E-XXoEB-EXBM-E--XXE-XMXEM-EXoEXXoXXoBE---M?EXEB---EEE--XoXEoE-XXBEEEoE?Mo-M-MXo-BB---f
-XX-EBB--XBBXEEBMX-M-EEEB---XE?-o---EXXEXBE--XE-EEEXE--EXEME?o-B-?Eoo-X--XE--XXBEX-?B-XXX-B-E-M----Boo-EXXX-X--oXX-XE-E-oE?-o-o-BEMX---ooEEXE?oEXo-MEX-??XX-XXoBXX-EEoX-B-Bo--XEEB-EM-X-o?XB-XooEB-XXBEf
-MEX-EE-oBXX--E-EEoE--X--M?o-XX-XX---MoBXXEEoEXEM-XXBoEM--MX---EX-XMo-EB-oXBXBXo-EEB?--X---XX--M-X--E-XXBBEoooX--o-?EE---o?EM-Eo-X----o-oBXE?X----E-EMoE--BEE--XEEEX-B??EB-B----o?-X-EoBMXEEX-----MEEBXf
-E-----XE?B?---BX-BEX-E?-o-oooM-EoB-o-EEBXE-E-XXXE-ooXEEEM?X-M--EX--E-B-XXXEoX---MM?XXB-oE-oB?B-Xo-X?EoM-EB--EX-o?X-o-EE-XBXEB--EEX---XBB----XEX-MEXM-BoE-oXEMoooB-oEEEoME-XoXoX-EXX-ooBE--BEX-EoEBXMBof
m-?MX-BXo-XBEXEXMBEM-?X?E-X-?-X----?XXEB-BoE-XXM-oXBoXXX??XoEBE-oEEX-E-X-BBBEX-X--EEXX----o-ooEX-M-XEM-oX-BE-XXBBE-Xo---X-?--XEX--Xo-X--XEX-XE-EBE?-X-E--o-o--XE-XoEXXE-XoEBX??X-Eo?Xo--EX---M---E-BME?X
XE-o-MBEEXoEXX---X-E-XE-EXoEMXX-E-EXE-EMX-E?EE-EoX--ME-oBEE-XB-XE--X?E-?EBXBBBoM--XEMo-E-?EXEoMoB--?EB-E-EXEXXoE-EBB--M-EBXM-o--M-EEEE--o----oXXoX--E-X-o-BXooB---oEoo--B-MooEBo-X-E---BBXX-XBEBBEB--X-X
