--E----M-M-----B--o------X-X-B-----?oXEBE--X----X---------E??---X---BM-X----?-E-o-----o-M--B--M--E-BM-------X-B----EB-o--M-E--X---o------M--------M-Mo------E--o?-M--o-B------X------B-----B------M-o-E-
--EX---?B---B-B-----o-XX---MBE-E---M-?---?---o-----X-?----------B?------E--X---------------X-E?--X--B---M?---?-M---E----M--E-E--E?BE-----XBXoX--B-----X--X---?--oX---B-E----?-E?---X-X------Mo-B--------
-?----M-B-B----E--o-M--B-M-??----B--B---o-M--BM-?-EM----------oM---E--o--X-?-------o-E-E---ME-X------X-----X----?o--------B-o-?----BE-----o-----M-------------E-MMB--XE-B-o---o-X-BXBo------B--MX-MoX---
---o-X?-E-----B--EMEE-EB--o------E-E---------M-?EX?---B--X---o-M----B--X--?-o----o--?--M?M--o-X-E--o---X--XM--o---------X---------M--?E------E-o-oE-E--EX---X--M-----o---?oB-----o--E-oB-----X-----B----
-o-o-------M-XE------B-o-E?X---oE---?--o-BB---------M-----M------?XoX--X-o------E----o--------?------?-----XME--B----oEo----MM-----M-MB--M--o?----E-oB--B-X-------o--o-----E------?EB?--M---o-EB-MM--X--
-oo-oX---oBM?o--?--?-M---------B---E-o-?--XM---o-?B-M-M-BM--XEB----------X-M-?-?-------XEM--EB------o-MB-?-B-------------XM--E-M---X---E--------B------?E--M-Bo-E--?M--------?--X-X--EX-EX-------M------
---Bo--E-----------X---E-----o-M-X--E---?-M--o----E-----E-oXB?M---------M---B---MMX---E-XEX---------EBM-B-------------------MBo--?B---??oEX----E-------?-------o----X------------?---o-B-------?----X-?-
-E---B?---oB--E----XoM-----?--------?------EM--MXEB-M------XM--M-M-------M-XB----X----------?----------------o--------XEX--M-E---?-----------o-------B-X-XB------?--E-XB----BXM----M-B?-M--M-o--B--oo--v
-oB--o----X--M---MX---X-----------X--MXX---M-E-o-----------?o--X----M-B--M--o----M?-M---EE--------------------Mo-XB?o----oBMoM-X--X---M-------BX-BB--M-BM?-E-M-X-----o------X------B------B--M---B-----f
-E----o-B--X-B--------M-Xo----o--X-B--?------?---?-----?-?--E-X--o----oM?-----?-XX--------X-M-----M------X-MXE-?-X--o--E-E---M?--o--B-------oM-?-E-?E-X---Xo-----?-X---E--M?-M?---X----oEB--?------EM--f
---E--E---?----oM----?-X-------o--------EE?E--------o--------B--?----o-----------X---X-----B---o-X-M---E----X----B---------M---------oB-MEo--M-------X-X?BB--B-X----E--XBM----oB??-M---EB-----o---X---?f
--X-B-?-----B-B-M-B-B----o--M----o--B-B---BoM------------X-E-o---E----------o-o---X--oM-?-E---X-----X?-M?-----M-?E-M-E---?M-E-X-oE-M------?-EMM--?--------X-B-oEo----oB---XXE-E-E------?--EM--oXM-B--?Ef
---X--?X-o-E-B-M-E-----MM--------??B---oX---EM--EE-----M--o----E--?--M-X-o--B-X----XBB----M----o-E-?------o-M---X-------XMB-----?-o-E--------o-M--M-----o-X----?-X------X-------E--M--Bo----B-?--oB-X-Mf
---BE-------B-----?--------------------B-?-----------E-o----?-----Eo---?---?E---M--o-o--EM-ME---M?-M--o-?-X-----?--------B------------B---B?---o--M--B-M-----M-----M--?E--X---?-EB--?B----------------of
m?-E---?----M-??--Eo-?B---??--MM--TMBEM-E------M------B--o--X----E--MT---X-T-----XXTE--?---oB--T----?-o-------XX-X---TX----BBM---E-------BT-Xo-X----BX--E-----EE-------E--XX-?--M-M-----X--E--o-oX-MB--X
XoXXXoX?XEXMXXX?XXXEoX??BXXXXXXXXX|XXXX?XXEXEXXBXEXXXXXXXMXXXXMXXXoo?|oEXXE|?oXXX?X|XXoXX?MXXXX|XXXXMXEMXXXXXEXXBEXME|XXXXXXXMXXEBXXXXXXMX|XMoXoXXXXXXXXXXXXXXXXoXEXMXXXMoMXMXXXXXX?XoBMMXXXXX?BXEXEXXMX
