-----XB--M-----?--o---------------B-----?M?-------MXE--oB-?o---EM---E------M--MX---X---B-----oE-----------B-X-X--B--M---oX-EBMo---B---XM----oE-o-------X--?----E?-B--B---X---oM-X---?--E-----X------?---
-----?-XM--?--E---X-----M------?---E----oE-------MM-o-E--------M---------?---------X---o----BM?M--------X-M-oM---X?-E--X--M--X---?M--B------E------o?M-------o?--------BXB-X---M--B----M-E---EoM-EX-E-X-
-B------B-------M--------?---o------?-----BE--------X---X------M--E--B--------?---XB---?-------X--X-B----E-oE-B--?o------BM---?-----E----XoM---MX---M----X-X?--M-X----X----B-Bo-------?--?--EE----E--B--
-----?-B------XXE?--?-------XE-----B-M---B--B--?----E----?Mo---M--E---EBoBX-X-?-oMo-EM--XB?-----X-E--M?B---------o---BXEX-----MBE--o-M---------o-X?--------E-------?----B-?--?E----M-----B--------B-o-X-
-----X--BE--??--BE-----oX-o-E-B---?--Bo---B--?M--Bo--?----X------?-X----M---X-BME--B-----X-?---?--?-X-XM---B--M----?B-------Mo---------Bo---B--o--E?M-----?--BXo----------------B--X-?-o-o------B?-E--X-
---oB--Xo------B-------M-B------X-----E--------oo----Mo---XE?--------?-----E------B-----oo-E---??-oEXX-X-o?-----X-------o?----B-M-oo---o-XM------ME-?------E-------------Xo-M-M---E-oo-----o-M------M?--
-oE--X------X--E---Eo--B-----?-?MX---o----X----M--o--Mo-M-------------E--oXX?--M--XBM-----X---E---E-M---X----XX------E-----ME--XM--B-EX-E-M--?EM-E-BX--E-oXMB-E-----E---o--B-----M---BXM--?----E-MoE----
---?E------X--X--Mo-Eo--o-X-B-----X-??-?-?---------------E-oo--o----?----?-B-B?M-oo------------?--M-o--E-B-----BBoX--o-X-B?E--B-----------E------?-X-Mo--E----?o?----E-?---oE----B-----?--Xo------E---Ev
----?-X-----E------?---EM-X-X--oXE-----o-B-B--o----B--?-?-M-----o-E--E-E?o-?----MM--??-BE---MX?--B-oo--E-?--oM--o--------?o--o--o-M------?-------EX---o---o--Bo----------EXBM-B-E----B----oMEB-------M-f
--oE---B---M------------o----------M---o-?---?----EE--XE-M-?---oM-E-o-------M-??--X-M------X-BBE---o---XoX---o--E---E-----??-----BX---EEE-X-?---B----o--X---?M--X-----?---E-------B----EX----M--B-oX---f
------MEEoo------X-----B---B--B------EB---XXX---?-EM---X--?XoE-EB---o--------------B---?------------E-o-----B-E--E----?----?--B--o---E----XM---X-?BX--?B----?---M--E-----?--M?-----X-----M-MM--BE?-----f
-?--BE--X-------BX----X---E---M-------?------?X-?---------?E-----------EB-o-----?--BoMM-M----E-----XMoo---?B----o---BMX--?--BBEB--?---E----oBo----BE-o-BE-o-?--?ooEBM-E--?--Boo----M-BBE-X-oX-M----o--Mf
-----?-----EBEB----------XBo-----?----B---E-?---E--BE---B-?--?-B-?----------BM----------B-MX--M-------------oM--B---E-E--o--------E----oB---------X?------?--?-X-B-M---B-EB?-o--------?--E-------E-o-o-f
------BM-E?-----?--B--M----oB?B---X-X---X--E---o-------X?---o---o----oB-------M-oBo-?EB----o--X-------B-B-M--E-------B--M------?E------?-B--?---B------B-E--EX--BMoX--M---o-B-?MM----?-EE------E-B--?-Xf
moX--BB---------XBBB-------o---E-M-??o------------MX------?-----B-X-B-----?--?-B?o-----E--ooo-MM--?-?-B----X-X-X--E---E-------B-----------M--X-o----------M--M-ooXo-?o---X-----X---?-o---M-----o-?M--XoX
X-E?--X-E-o--X--------?--BB-----X---X-M---BE----o------E---------?--B--E-----M---?---?-XX---M----B-B------X--X---o-o----------MBX-BB-o-------E-XE-B-----Bo--X?--?-Eo-------X--o-B?E----B--E------------X
