---------------X--?o?---X--Eo--XX-X------Bo--MX-M-----EoB-B-E---EM--B-o------M----o-E----B-B-----M-M--Eo-BX----B--?-----?E-oX-----E--BE--X-X-?M-??--B--X-o------XB--------?--------M-X-B-M---B-o--M-oo--
---oMB-E--X--M-Mo------B--E-----M--B-M--X?o-?-M-------?-B-----o---o--------BBX---o----------Xo------E-B----EE-MB--MMM-X-E-??------------B-M?oEo----E-------E---B-E-EMo--o---?-E--M--?---?-EX------?-----
-M-XMMB---------B-E----------o-X-?--o-E-XMB--------------EB-B---M---BE---X-----EXEE-----------?M--EM-oXB--BB---?-oX----BE---E---B--------E-M----MB------X-----Eo-?BX-----o-EE---E-Eo-B-Eo--M--XM-?-M----
----M---M--BEoX-------o--o--o--------BM-B?X-X--------?---oX--?EM--M-X-------?-B--B-BX-E----oM-E-M?------------M-----Bo----?E---o?-B--B-B--M--o------------M--------B-?-----E?M----B--o---?----?-B---E-?-
--E----XE-?--M-o---?--oX--E-E-o--o?----M---X---B---o--------M-B------MB----o--o--XM--E-Xo-?--M---------XM-o--X----M-------?-B-oM-o-----?o-?---o-B---------X-E-----M--o---MMEMB--M--------?B-----E---o---
----?-BB----?---?---M-?--------?X----M?o---oB-oo--M-B-o-?-o---X-oE-EX-E?-EX-----?-M----------?-XM-M---------E-EX----EB-M----?-?---X--------EE---E---M?E---M---?----MM---------X--E-BB---M-----X?----M---
-----o----E?-?-MB-B-------oo-----E-X?-B----?-?----E-------MB-B--X-X---?o---X-?--B--?E-B-----M--o-------M--X-?E--?-----M--X--BX-----oXo-M---M-E-------BB--?--------------X-------B-B----B------X--Bo-?-B-
--------M-X-EMM-?ME-?-B----M-M----M-MEB?--B-o-B-------B----------o-B-M-M---?-E-----?B-----MB---B---X----?-B-----?---??oo-?--M---o----o--------o-?-------X----Xo------oMo---EEM?-XE----oX---B---oo----M-v
------XX-M?-M-E-------?-E----------X--------X--X-B--?-B----M-E-?o--------EEE-o-------o-----E-B--M---o--o--E?-----?-oo-----B---o---B---E-o----------M---BE---E---E--E-MEo----X-E---o?-E-----EX-----B----f
--?-E--E----E-----E---B-?-E--o-----X?--Mo?X---B----oX---X-----B---BX-E--BB---X---o----X-oMoE---MXBM--------M------B------EE------BM-----B-?--------M------?X--o-?-----E--X?-----------BB---M------B-??-f
--?--o-oE-----o------------B-X-E--------E-EoX--o-?XX-------X---o-------??M----?E-?--------?-M---M-oX--o-M-Bo----E--M--o--X---?--Eo----oE?-----------BX-?-----B----M-----E-M--o----E--------M?oXXo-----Bf
-M--M--oMM-o-o?E--E---?---------M----M--B---?--?BX----o-----------B-----M--?---B------E--M-BE--EX-Bo-----o------X-o-M--MX---E--?-------oEE?o-o-o-E-BM?EB-Bo--M-------B-BB--------E-ooME--M-?---------B-f
---X--X--o?X--MoM--oo----X--?------X-E---------B-------?--MM--BX---------M---M?--M----??---o--B--B---?----X----??--E--X---M-XoXB---B--BE------?----?E--M-o-----X----EBB-----M--oEo-o------o-----------?f
-------------o-E-----??----------B-MXX-----------o-------?-o--o------?-B--oMBX--o-E--oo-------B-X-X--------------XX-----E-BXo-X?----------M-X--B--X?---E-----M--EX-M---------?-------?-----?X---o--X--?f
m-E---EB---X-----X-------------oE-XB----M--------oX-----X-MB------Boo?-----M-----X---M-----?-E-----EEo--oX?X--M-EBM-----BX------MM---E------B---XX-M-oX----o-----M?----E--X?E---ooB----o------X-------BX
XXXXXXXoBXXX?XXXXXXoXXXXXXXBMXXXXXXoXMMXXXXXXoXBXXMXXXXXXMoXXoXBXBXXXXXXXXXXMEXXXXXXXXXXXXXX?oXXXXXXXXXXXXMEXoMXXXoXXXXXXXXMXXXXXXXXXX?XXXMXoXXXXXXXXXXXXXMXXX?oXXXXXEXXBMXXXMXMXXXXXEXXXXXXB?XBXMXMXXXX
