------E-----EoM?-M-BM--E---B----M-M--?-o?----o--?---B-B-----o--B-?-?------BB------?B--B-----oBB-----o---o-----X----M---M--E--EE------oo---oMMB---E-oo--E--E-X----X----o--?----XE-X---BX-o------M--BBMo--
----X--XM------oBB---E------MB--------------M--M----EX??-----------------B?M-----ooMX--E----EB-M----E-M--B----E-B-o---M----MB-E----B--o-M-E-----o--------------BXMM-B-----EX--oE-----o--EE-E--ME---X----
-----------?------oo-M-----oM-B-------M--?----------X-X---XME----o------o----?---------X--B-----o--E--XX-----E------?o---E-M------o-?--------M-----?-E------?M-o-o?--B--M---o-----B------M----E---M-o---
-----?X--Mo--EEEXXE--X--E-o-M--BB-E----XE-X-o-----M-XX-------MB---X----?-?EB---E-?--------?--o----M------M-------B--------o---------o-?--M------M--?---?M---E--------B---o-----?--?---E--o?X-E-Xo----M--
-----?-X--o-----------BE--X---X--M----------E---BX---o--?-M-B-----M-----M---o--E----------M-?--E----------M---BoMB--?----------ME-B--XB-o----B---?-XX-----X?---B---M---EM--M-o--X---BB--EBX?B--X-B--ME--
----B------B---EM----------M----X-o---o---M--oX-------M-----X?--?o--XBB-oB---?-X--Eo?--E----oB----------B--XMX--BE?Bo-?E-XB---X?X-----------o--Xo------?-o-?-X--M---X--------X---o-o-o--M-E-X-X-------E-
-----M-----B-M-X?o--B-----M-----o--?---E---E-o-X--o--------o----?---XM-B----M-E---o---X----E--------?-oX---??----ME----MXE-M-o--X?-----o-----EM-XXE-EM-B---?--???--M----B--B--M------EE--?------X-----o-
----------o-?----o--X---B-B---MX?B--o-M------B---MX-Mo---------?oB----X-B-MB-------M---B--------M-----B--o-X-X--oX------EX---?---------B-----??----E------E-?--B--M-B?-------------o-B----M-----XE-----v
-E--E----?-?Xo-----o---X-B--B?--E---?----oB---X-E--EB----E?o-E---o---M-------E------E----B----?--------M---BB----o---B?----B-B----oB-B-EE-EX--M-M--------X---?-----X?-E---?-EX?-B--M-------MB--E-------f
--E-?------?------MX--X---XX-?----o----?----E--B----------?E------B-XB-Bo------o-E-B-X-XEMMM-X-?---B-----M----XMoX----EB----B-Eo--?-E----o------X---o--?--Bo------?o------X-o-X--o?----M-o-XEo--X---EB-f
-M--E-----E-ME---M---------XX-----o-----BM-?--BM--M---o-??---o----E-E-E--E-o---?-?-M-------------M-------oM--X-X----------------?-X--o--XM---o-o--BB-----oBM---E------MB-XX--ME-oE---o-o--M---Mo---B-B-f
------M---E-o---o--B---MM-o-M-----EBX--B?--M--B-----ME---M-B--?--XXM---MX-E--ooM-----MX----?X-M------Eo-o--MM-B---X-M-----?-o------X-M---XE---B-X?-----o-----------M-Eo------X---X--X---oX-?-o?B---B--of
----X-XX-----o-XM?---o---E-B-?-M?MoBE-BXo-----BXX--oB-M-------X?--ME---------M-------MM-E---Bo-Eo-M---?M---?-----M----MB-----o-----------X----Bo-----?-M---M-X--B-E--X----------oME-------o-------E-EoEf
-----E---BoEX----B---o------?-------oX----E---BB------------E-B?B---MM--E?--X---B?M----------MBM------M--oX--?E---?---o?o-?----oE----?XE--XM---------M-M--------?M-M--o----------o---X---MBE--B---B-oo-f
mEX--o?Xo-----B----T--MB-B--E---METM-oB-----M-----?-o-----T--o-o-Xo---E-o-----oT?----o---?o--E-M--------M--?---M-o---------M----o--T--E---------o-B----B--?--M------EXoMo-----?X-----BX?B-BX-oE-----o-MX
XXXXXXXMMXXXXXX?XXX|XX?XoXXXXXXXXX|oXXBXBXMEBBXXXXXX?XXXXX|XXXEMXoXXXXXXXXXXXXX|X?XXXEoXoooXXXEX?BMXXBXXXXMXXXXXXBXXXoXXB?XXXXXXXXX|XXBXoXBXXXXXXXXoXXBXEXXBoXXBX?XXXXXXXXXXoXXEBBXXMXXXX?EX?MXXXXXBEXEX
