-XX--Eo-X?X-E?o---?-E-----Eo-E---EXBEE--?BXEXXEXBE-M---EBX--XB?--EX-oEX---BX-o--oX-XEo---EXEEXXMEXE-XXXEMXBoEE-EX-E--BXX--X-oE-E?XXXBBBooMB?E-BEM-EXEBX-o?-XEoBXE-X--E-o-ME-XX-oXoX?-XBEEo--EXE-E-XEB-E-
-X-X-BB-?--EE?E-X?MXXE--EX-E--EEX-M--X--XBXMBE-BXEM?EBE-?ME-B-XoXooX-E-E-E-o-BX--EMBX-E-E-EMoX-M-XBXE---XXX---oE-B?X-X-B?o-ME-XMB-EXXBBXoX-E-EEEXXXXX-EE-EX--B-?XEEX-ooEB-EBXB--EXB??-XMEXBBXX-?XEX-XME-
--B-EoXXXEXXXXEB?-oX-oo-EXEoE-EE-oXMX-M?o?BoEB--X-?oE--M-XXE?EoX-BE-B-EBXXEEBXXEMoXEXoE--------EXXoEBX?-Eoo--X-BX-Bo-EXoEXXoB-EBB?-EBBBXXoX?B-X?BE-oE?o--XB-EXX-X--E--XXooBXB---E?XMX--X-XBXX--EX-B-MEo-
-E-XoBM-XEBXEo-X?EMoEM-E-o-BoBMoEX-M--oMXX-o?ooXoXXX-EXMo--B--EEM-X-B--ME??XoMBEBEXoXoB-oM-o?XE?B-oEEoE--o?EE--oX-E??XBXE-EEMo--M--EX-XXXXXXEE--?oXX-X---EBo----X?XBXEoXX-X-oX-EE-----EX-X---?BX--EXM-E-
-X-Eo-EEE-?---?EEXXE--Xo-E--oBEoooEoX-B?XEEoXE-oE-o-BEEoM-X-oBB-E----E--B-XEB-oE-MMoo-oXo?EE---EMo?-oXEEE-BBo---E?XEo---MEEB-E-XXXXXBo-XB--X-EEM--E-EM-BEXE-ooMME--B?X-E-EEE?-B---BEEBXEE-XEB--?----X-E-
-oEEB-EBEXo---MBoXB-BMXEBoBMX??MEX-E-MXXE-XEEoo-EMo-BX-XBEXE-EE-EoEXE-EE-E-o-MMX-X-M-E--XXMME-X----oME?B--M-EBo--X-E-E??EXXMXEE?-oX--EB-MX--o-EXoB-EXB?BEoBB-oMBMo-B-X-EoX?-BEo-EBEMEXXMX-o-X----X-X-EB-
-X--X-E-EE---X-EE?EXXXEoB-E-E--X--o--XBXEBX-M-X-BEMX-X-EX-E-?-?-B-XXX-XXX-EBXB?oEEMEE--EBoX-E??-EX--XX-XEXXo-X?--BEX--XXo-?-EEE-?-X-X-oX--X-E-XBBX-B--X---EMM-?---E--??X-B--BXXM-EX-EE-XoXB?-E-E-XX-EB--
-oBXo?E-oXB--X--BM---E---XEM-M-EoEE-?XXBX-BEX-EE--EEE?XX-ME-EMEE-EEEo-MEBX-o-BBBo---BE-o-E-BXoMBMEXEX-X-E-EXXXB?EEX-Mo--EEB-o---BEBoXX--o-BXXB-XEEoMX-XE-E-EXBBXEMBXE---E-BEXBXo-X-X-X-MEEo-E-BXo-EXE-Xv
-??B-X-XXX-BXM-BEEE---EoEXEEX?--E?EBEE-oE-MXXEX--BEBo?--oX--XBE--BM-XoXBEEE-E-XXXoX---XMo--X-B-Eo-E-oo-EE---X--EE-BoX---EEXX--?EEX-EXXEEXMEX?-ooBEMX-oME?B-o-E?oXXo-oBE?o-E-EX-ME-E-XE-EE----Eo-XXBXE--f
-oBEME-EMBEE-BE-EXX-EEXE-B-XB---E-E-M-EoX-XB-oB-EX-oX?-oEo-oXoXoX--X--XXE-X--EE-oXEX--E-EBEE--EXBBEB--??-E--XoEo-EoEoBB---EE-X----X-XX?BEMBBoEEEE-Eo-o?oX-ME-oXMoEB-?o?--B-o--oooEE-EooEEE-X-MXXBX-XoX?f
-X-EXX--B--X-EBo?--XBXE--XXX--EX?XEX-Eo-?-BX-X?-E?XEXEBEX-BEEoB?EX--XEMX-X?B-B-E?-XoE-E---E-EB---M-BMXB--XXXXM-XEE-X--XX?XoEEBMBXoEEEXMEXX-EXXBB-o-Mo-??--MEX-XXEoE----E?E-XoMEBXoMB---BB-E-XXEoBX-oM-Ef
-oEXB?oXXXBM-XMMXEXMX?oX-E?-BE-MMo-X--E--EoBX-B-oo?B---X-E?EE-o---M-Eo-MBE-BXE--EoBE?---E----E-XooX-?MXX--BB----XBEoBX-E?-E-X-Eo-?XEXoEE-EXXM-XoX?XX-o-XBEXX-XEEoEB-B-o-EMX?X-XEEX-E-XoM?XEMX--X-XEBEMXf
-?X?XMoMB-----X-X-EEBEo--EoXEEo--E-BEXBEX-?XoXXM-XEE-MoEE-?X---XMo--XE-B-?-B--XX?EM-EEE--oBX-XB-o--XXXM-EEM-oo-?MXo--BX-Xo-EXE--oEE-MBMEXM-ME--XEX-EBB-M--XMBEEoo-EoBB--XEEoooEo-?XXE--BMM-EX?-XXE--XE?f
---EE-X-o--EX--?MoEM-B--E-EE-BEX-XBXB--E---B--X-X--B--?oX-XE--o-XEM--oM-?o-EB-?-M-o--X--E-MXXX--?XB-?XXEX--XE-EEE-ooM--BXoX-?X-BMX-Eo---?MEXEoEoEBE--XE-EXE-?-XEEoBXEXE-ME-XXX--EEXoE---oXoB-Xo-XoBEoB-f
mE--Mo-XoBE-Xo-BXo--XE---EBE-oMMEEoX-?EBMXXEXE-X-EEoEXEoo-Xo-oM-XEEXX-EEo--?oXE?-XE-E-oX--XBoME-X-X--EMXXEo-oXE--X-XXBBooX-M-XMXXE-B-oXEM-ooX--X-o?XE?EoE-oXo---B?EXX--o?-X-X?EBE?-o-E-BoBXE-BEEXX-EXE-X
XE-EX---EX?X?-o--?-EMX-E-EXEEBoXEEoo--XEE--B?E?-o-o?EM--BEEXo---oEXXo?X--XXo---XX-EoXMEo?--oEEEXMXBB-EX-oEX-XE--MEMoXE-XEXEoE--EoX--XXBB??o-X-ooEXXEXEEEBXXEX-EXBBEBX--BMEX-Eo?X--Mo-B--oB--E?E--XX?E--X
