-o-------------o-------X-----X---M-----o-----E---o-M---M--?-----o---X-?--MB-----M--?M-E-X-E-B?---X------X--M--M---o----M-M-o-----E-----BXXX----------?ooX--oXX--------B---o-B---o---X--M?XX-o---o--?--?-
-----X-M---E-EM?-oXX--BM-----M-EB-EBBB------X-----o------o-X--X--oEM-----X-----------EME--?-o-?---o---B----?--E-----oo-BM-oBB-------X-B--ooX-X---------X---------Mo?--E-o---X--o--------o----?---?---E--
------------E--EBo----E--Bo--o------MM------o-o-Bo?oBE----------------X-------B---------B----?o-----B-----------EX-----BM-EE-E-M--M-----------X--o-X--Bo----?-----M-o---BM--M-----E---o?E-E-E-oM---o-oX-
-o---M--?----E--X-------X?--oE------?-EM?-------X-E--B--B-EM-------?--EoX-MMX-M----------?-----??-----oB?o-------o---o--BXE-----------o----?-X?---M--------------BXX--oo--M---o?--BM-M----X--B---o------
-XM-?-ME-------BB-------MoB-o---XX------M--B----?o-?-B-----o-E-------B-----o----E------o-?-X---M--o------B-?-----------MM--M------------M--XEE-B-M----BM--?--?---X-----?-----M--MX---BB--MB-?o-M-M--M-o-
----M-o-M-?-------------M----XM--M-E?oB-----Eo-B---X-MM?---XoE--?-M---BME-?---M-?----E-----B----B-----X?-E-?-M----B-B--oM------oE?-----E--------------E--X-B---------------E--------B-?-?-E-?-X-BX---o--
-E--------E--B----MB-B-E-----EM---EEo-----XX-EXoX---?---------?B-----------?---BMo-E------X---Bo-?M-o----------EM?------?Eo--B-------BE----o----?-E--?X--------X---M--E----?-B--E--------o---E----?o----
----B--B------------E-M---E-B-M-----XB?---X-E?-o--X----------M-?-?E-------o----------X--E---o-----------M-?---X??o?-o-oE---------------o-----oX----X-X-?--?-?---o---?-------------M---E---X--E------o-Xv
--?-M------E?----??-o-----B------E-?-B---M----oX---B-------o-o?--E---E----E----------?-?B---o-----X?--X---E--BM-o----M----?---E--B------B-E-X-o-----?-----?B-M-----B----X-------?--X--o-----M-o-----Mo-f
--MM-------B-??B-----------B-M-Xo---M?M---M---X-----o----B-------M-M---??--o---M---?--o--E-B---E----?--?------o---M-------oX-----?-------BX--?-------------B----?--MB---M-oo---Booo-XE--X--?---B-B?B--Bf
-----?Eo--------?---o--B----o------B---E-B---o--------B--B-----E--?--XE--?--------E------?---BB-M-E-----EM-B---B--?------B------o-----E-X-E-oo-X--EMEE-M---o-----?---------M-B--B---MM--?E-o---?--M--M-f
---EB-------X-------BB---M--o---M--o-?--MB-???---B------E---E-M--E----o--MB?-M------E-----?BX-MB----E?-B---X-?--------o--X---?-E----oM--M-?-o-------B-M-EM---EX-?M--B-Xo--?-BM--o-----?---E-E----B-----f
-B--o-o-E--B----o--B--B-------------oE--?-----M-o--?X-E-----------o--M---------X--?---------B-?--EX-?--E--E----E--BX-o-----E?X-M-o---B?-?-----?---M?----o-------X---Eo--X--XX-oX-X----MB-E------------of
-----------M----BB-oEBEM?--?--o-M--B-E--X----M-----M--oE-M-ME--------?--o--o?B--Bo----B-o----------E----------X---M---oX-------B---?-EB--o-M--------------B-------?XB-------B--o?--?----?---X-E----?BXBf
m--B-XX---MM-?-oM-E--------X-----------E--o-B-o--M--M---E---E---M--B---B-------M--??-E--?X-M----?-----------?-X---X-----M--E--------oM---B-M?-o---?B--------------o------X-?BBo----E----M-XE-----B-o---X
XBXXXXX?XXXXoXXX?EEXXXEXX?BXBXX?XXXXXXEXXX?XXXXXXXXXXXXXEXXXXMX?XXBXXXEXXXX?oXX?ME?XXX?X?XMXXXXXX?XXXXXXXXBXXoXXXXMXXMXXXXXoXEoBXXXXXXXXoXXX?XXBXXXXXXoXXXBXXXXXMoXXEXXXXoXXXXXXXXXXXXEXXXX?XXMMXEXooXXX
