?---E-M?--M-------E--X----------Mo------o-----M---?---o-?-------B-E-?---M-----M?--E----M----X---o---M-B?-Xo-MM-E-X---------XXo-----X--------o-o----E-?-------M-BE-E-----E-E-X-E-E-----M-----o-BX--o----M
E----o--M-E-oX----X---X----?--B-?M--B?-?--X--B----o---?---?---B---E-----o--EB-X-------o---E--??--------B--E?o-M--------Eo--?--E-B--E----------o-E------X------X---?-?--?-o-X-?B---?------?-----?--?----T
E-?---E-----o-M?----B-M?-BE-E-o--E---?M----------EX---?----X--B---?M-B-----Bo-----E-oB-?-oEM----XX?X-E----??--EMM-o----XE-----?----B------XXM-EE----M----M------o----oX--o--o----?-------E-X--E----M---?
M-MEE-XX-?-B-oo--------E-----X-B-B---M---X--?oX----B------------M---------o--------?--EMo-oo------oE---X-----------B-------o-o-o----------E-X---M-B---o?----X--Xo-----------o---M-----B--E----o-X-E-?XEM
T--?-----X----o----o----Xo----E---M--------EX----E---MB-MX-MEo-o-X--B-M------X?-BX------B----B---?-----X--------?--X-X-----M------M-M-X---M-o---ME----X--o--Xo--B--B-----X-X---B?--M-----X---B--------EB
|---o---?-Bo------E-B--X-E?M----BM--X----X-o--B-M--BE--------?M--B------B------?--------MBX-X--?EE---?---B--?-E-----M-?-----o--o---oM-----X-o--BB---X----?----?----------B--M--B----B-oE-?X------M----B|
E-B--------X-E---M----oB--?---M-MEB----E--------E-M--BX----o---B---E-?EM-EM-----?-??---X--MMBX-Mo----M--o----Bo--B-M-XEE-X----BXX-----?B----?----X-----X-B---B-BMB--M-M----B---E----M---??B-E-----B--oMB
EM--E--X------------Eo-------M?MM----M-----E-ooEB---X--XX------B-----------B?----E-ME--o---ME--M-----------XBo--M---B--B-E-X--M---Bo---MM--M----M--?-E--o-?-BE?-B-----M-MB---XoE---o-------XE---------ov
ooXE-??-E--B?-E------BEEoB-------?----?E-----B------o-o------------B-X--?--?------E----------BXo-?------B-------EM-M?--B-oB----BE-E-----B--------B------BX--------M----o--X--B-----MEE--B-----XMB---M-BX
BEEo----?E------o---o--M--o?-----M-o-------------X--B---E--------B----EM------------------M-?--E-o---o--------------?X---E---B?------E-o---------------------B?---M--MBM--B------oB-----X---?M-?-X-----T
|-B----EoXBo---X?EoMB----?-B--X-----XE-X?-----------B---X-------------BE??-----Eo--?--Mo---B---X-----BE------------------?--??X-----X----X-E-MX-?EE?--X-----oE-X??M--X-B-?-------o--BX-Eo-----??--M--oXX
-X--o?---M---------XEXo--o------E-EX--MoE-----E-M--E-X----o-----MEB-o?----?---M--?--------B---------X--M---------B---o-MMM---------?--------B-o----E---------o-E-M--o-XM-----o----X-o--M-------B--B-B---
B---BE-E-M----?---M-----?X-o---o?-----?-----X---?--B---o-----B--M-o----B-o---o--E-o-EB-----X-----?--M-------B---ME-XX---E?-X---M?----------?-E-X-?Xo--B----E--M-XBM-----o-----?M--------B-E-B---X--X-X-E
oEB-B---?-o--X-?M??-?--o-----o----?oo-----------------------M--XM-M------o-----Eo-BM------E--?-?---?----?-?M--M-X-------XX-E--o-M-X-------E--MX--?MMX--o-E-?---Mo--E-?---E-oEE------o-EX--B------Eo--B-?
m-----X--o--X-------------M--E-X---M-oo---o---------BM---o-M?--?-E-----M--M?X-EEo-X---B--E?-oX-?B-o----X-----B?-----------E--B-------M-----------X---?--B---oME----MBo---B---o-?o-E---M?---B-?---B-B-?-o
XXXXXXXXMXXXXXXEXXXXX?EX?XE?XBXXXoBXMXXXXXX?XXXEoXXMXXXXXXXXXXXXXXXXXoXXXX?XXXXXoM?XXXX?XEXo?X?XoXX?XXXXXXXXXXXXX?XXXEXXBX?XXXXXXXXXXBoXXXXXXMoXXXXXXXXBXXX?oXXXXEXXXXoXXMXXX?XXXXXXMoXXXX?XBXXXXXXoXXXX
