--------B--?-o-E-----o---M-------E------------?--?-------BM--?--oB-B-oB-X--E--E---B----E?---X--------o?-----X--B-E--X?------M--E---X--MM--M---BX----E------X----XB--o--X------E--BX----o-M---??--EEE----
---B-?------o-----EM---?--------M------B-E?-----?-----M--M-----B----?-MM-o----X-------------ME--Eo--E--E-E---?-?----E-o??-----B------------B?----B-----BX---B---?-o-E----E-X--o------B------?-----------
----oo--------B-??-E-X-?-----M----MB-o------------B---M--X?-----E---EMo---o----E----XMB---?M-MB-----?----X-M--ME---------o-------E-o--E?---?-----o-------M-----X--?o----------oM-----------oo---B---X-E-
-M-B-------X---X---oB---M----E-------M----------?-------?X--o-E-o--Boo-o-BoE----?--B-?---B--M-----B-?----M-----E-o?-oX-------M---E-M---E------------X-oX?M---o-?------ME--EBo--------o--o-?-E-BX--o--?--
------X-E--M-MX--MM--X---X-E---o--oE--E----BE----B---X-----XM-X------o-X-B--B---------M-oM--?-X-----------M---E---o-----o----M----oE--?--B------X----?-----M-o---B-M--------XoM----M--?--XM------B-E-BX-
-B---o-B-------E--B-----X-B-----oo---o----o-------M-EE------M--oXB--------Eo--------o-----o--E---B-BM-?--M-----E-M--X--Bo---M-X--E-----E--X--X-o----EB?----E-?----?X?--------B--B--B-oo-?---?-??-----?o-
----MM---M-----X----BX----E---Mo-o--o?M-XBoB--o--o-----?-o--------M-------?--?---o---M--M?B-X-------------------EM------B--X-B---o---------o---M-M-B-?-M--XoMo---E?-----?o---o---M--------E-?---B---B-o-
--M-o--Eo----?------E----E?B-X------E--B----E---o----o--?-M--o-X-----------E---XMM-o-ME-E--Xo----o-X---?--XXM------?------XX---------E--?-oB----X--B-Bo----------o--B--?-EE----M-X--------XX----o?---EXv
-E--o------E--X-----M---M----M--oM--oX----M---------X---?--oo--o?BEB-M-----M?B-E-----?---M---BX-X--?XXE--?-EB--o----------------?-X--BE-----E?E-o------o-Bo-B--o-----E--M-o--------------B--------E----f
---E--E------?XB------------M-EB-M--M---E-----Xo---------------E--------?--BBo--E?---?EB----E---MB-----M------M------MBE------M---X-o--?-B-X----XMoX-o?------?-M---MB-XX--------M----EM-o----------Bo--f
---o--BEoo----X-X--M----B-----M--EEB---?B--X--E----o-MB-EE---X-------o----Eo-------E----EE--------o--MM-X---oM-E-M---oo-B--BEM---X--X---EB-------E----M-E-oE--BX---X--?--E---X--BE--o--X-----BB---X---Mf
--Mo-o-Mo----?------o-M?B------?-------oXB----oX----?-XM-----EM-EEM-------E--M-XX--o----M----o---X----------o--X--EE---EM-----X-?B--?--BB----o--o-M------X--XX?---M-M------M--E--BB-----M----ME------X-f
---o---?-o--B----o-----X-----X-MX-o-M-?-M------M--E-Xo-M-----oX-X-?--o--?oM--------E-----X------?o----M------B--B--B-o-B-?-----M------E---XB---o---------------B-----oX-----?-----X?----------------B-of
-oM---X--M--BB-B----B----------E-E-----------B--o--E-MB-----o-----E-------M--X-B-o-o-------?------B--X---------oE----o--o-Xo-??M----------E-M------?--B-------?------XMX-oo--X-o-E-X--B--------E--M--?Xf
m-o--B---B-----E--T-?M??---MB-B?---?--EE--------o---o-Tooo-----X----M-Xo-------TE-?----E-B-??---o-BXM--EMM--TT--o-------?-oE--o--B--T-o--B--X----B-----MX--B-XT----o-T---M------B---M-----M-X-B-----o--X
XXXXXXXXXEMXXXXoEB|?oXXXXX?MXXBXXXBXB?XoEXMXXX?MXEXXMM|XX?XXXXoXXXMXXXXEMXoXXXX|XXEXXXXBXXEBXXXX?BXEXMXXEXXX||XoXMXXMXXMXoEXXXXXEBXX|XBBXXXXXXXXXXXMXXXXBBEEXE|XEMBXX|XXXBXXBoXXXXMX?XXXXXo?XoXXEXXXXXXX
