----XEX--?M--MM-M--------B---B----------X-M--------E--oM-X--M---M-B--M--E-X-----E--E----EME--------M----B-----oX-?E--X------oM--Eo-----XX-B-----o?-B--------?---B-----?M?--B---o------B---X?o---?-E-----
-X--E-----X--o----o---E?--?--E?-Bo----------o----o--?--M--?------B-E-----M---EE----------E-------X-?--E--------X-o-E--EB-M----?----B---X----oXo-----E----MB-E-----?----E-----B----M--E------M-----?--B--
-?-XB-----B-o-------?--oo-EM-B----E-------E-M---oX--MEEM--B-X--XB-----?----M-------E----M---B--ME-B--X-----E-------B-----MX-----M--XE-------X---??----------EoM-?----E---o----M--B?--o---------XX----o--
-----------?E?o---M-B-----o-BE--o--X--?-XM--XX-o----oEX-----E-E--------XM-X-B------o?BB-MXB----------M?X--E-----M----o----?---?--------M------?--o---BoM---E--------B--o-oE--o---o--o---------?--X---E--
--X-E-Bo--X?B--E-?-X-----?----M----X--BE----------M-----EEM-----o-M-BM----M--?---E-?--M-------E----M-?o-o?M-Xo-E-XM--o--o-X--X--o-EM----?--------M--o--------?-M---E---E-----o--?-------M?--o-----------
--X-o----o-X-?--o---M-------------o-----B-M-?-M------o-o-----X--M-o---E--BB------oo-B--MM---M------?-B---E---------oo----?---M---E?-------Eo?o------MMM----B-----X--o--X-?o-Eo?-Xo--M-?---X--BB-E---EXB-
-B----B--E-XBX--B------oE-o-E-B-?XE--------ME---?--EX------E------o------o-o-o-E--M----B---?B----------X?---E---E-----?E-----B--X------?---o-----BB-----EXEX--B---?--M-M-M---X--X-E----X-M---o-------E--
-------BX---E----------X-----?---o--------------o?--?-Xo-----M----------X-M----E--X------B--B-----BX-----o----X-Xo?--X--?-?-o-M-------M-B----X-M--X----M-B--X-------E--E-------?XE-----?---o---X-------v
--M----o---?M-X---X--M-------ME-----E-X--M---M------B--o--X---o?X?--B--B?-o----XX------E-E--X?-------?---BB-X?--E---X-E----E-M?-----EXX---o--------M--------EB--M-M--Mo-?-E----MM----X---E---B---Xo-o--f
-----?o---XM-o--------E--EM?-----o-B------?----BXM------------------M-B----M-----B-----B-?B-E---M--?EM--o?B-?B-XB------------X------?----X--E------------?-----M------o-MX--XE------EX----------MB--oXEf
--?B-?-o-----ooEE--E---------------B------o-E-E---M-B-Bo----XEoM-X-----------------B---E-----X------XM-M-X-M?--?--E-?-------M-E-?--B-B---E---------X-----XBX-X-----------o?----BBB-M-------BX-B---o----f
---BBB---o-?E-X-EX----o---oo-B-----X------B-----X------M---?--oX-X---M--B?MB--oB--BB---?--??--M-----?-------?EXB----o--o----M-M--------X-M-?-XX?--X---ME--X--o-------??---MME--E-----B-----?----BM-o-o-f
-M----M---X--------M--MoXE--?--E-B-B--?M-B--------X-X---E------------M--?-X--MM---B---?--XM--?------oo-B--------XB-o---B-E---B---?--E---E-------?---?M-B---X-X----B-o--M---X-X--EEE---o-EM-------X-Mo?-f
--?X---------?-XE?E-B-------M--X-B--B-E---?-X----B--X---E-----------o---B??-X---M----?----??---?-------------?B---------M-?---o-----B?-----E-EB---------M-M-----XE----MM------?--M----XE--B----E--o---of
m------oE-E-BE--EM-TM----E--Bo--ET-----EM-MT-X--E----M--o----XBB-M-TBB----B-EE---M---T---oEo-M-B---o--o---T----X--B----oX---oMT-B--o-M-T----oE-E----o----B--o--?--BT-E??-EMB-?----T----------BEoE-----BX
XBXBXXXX?XMXXXXXXXE|XXX?XXXXXXXXE|XXXXXBXXE|XoXXMXMXBXXXMXEXXXXXXoX|XEXXXXoXXXXMMXBXX|XoXBXXXMB?MXXX?EXXXX|oXMXBXEooXEEMXXo?XX|?XXXXXoX|XXX?XX?XXoXMXXXXooXXXXBXMXX|XoX?XXXXEE?XEX|BXXXBXXMXEXXXBXXXXXXX
