----E-o--X----------X----?B-?---------B--E----------ME----XB----?X-----E?----X---------?--B-----B-M--M--EMBE-----?E----B---o--o-----B--o-M--XB---o---?--E----E---X-E-?-B-E----M-X------------------E-?--
------BX-B------------o-E-B--B----M-X---X--------B-?-M---EM-B-E-o------E-X-E----X-?-----M-Eo-B----oXo----B--M--Mo-BB-?B-E---X?---o-Bo---XX-o-B---X-B------EBM-------X-B---------E--?-E----------E---o-B-
--?B---E---B---X------M--X-EE?-E-----E----E?------E-Xo-----E--?B--X-B-o---Eo----o-BM--B-EXB-----?-M-XE----M---?-?o-----B--?o--BE-----?BE-?---------?----B--X----B--M-o------M-M--E------Bo----o----X----
-X--X---M----X--X--?o----oE-X--EB-oB---B-o-------?----EX------?----EBM--B?-o-?o----E-o--o-B--X-?---M---------M-o?M----EE?-------o----E-?-----B--X-E--?-----------M?----E-?-o---M--oEM--?-X--B-----------
-----o--B---?X--XE?E--B--B--?-Xo-XM--o---------X--o--E---?E---E---X--------o-?BX?---B-ME--B-B-M-?--o--??-B-o-----?---EM------E-B?---M-E---M----B---?-EEBM--o---??o--B-----o--X------XE-XM-----X--?------
---M--------M-E--------B---E----o---B-M--EB-----M---X--E---Xo??B-?------XX---?E--M-o-----X?---X-MB-Xo-o--B--XE---o-----o----EX-B----?-E-------E-EB?B---E-----------EM-oB----EBM-------?-B--------o-E----
-?--?---M------M?E-B--BE--X--B---o-----B?---------E-E--XM-B-?--o----M--?--o?M----o-oM-------M---B?--M-----------E----M-E------?--E-?---?-----X-X-----?-------------------------M----X----E-X-X--E---XEB-
-----?MB--B--?-M-MM-M-M--?-EB---------M--?E----o-----X-E-MM--------o-EEM-X--E----E-M--X?---M-B----Eo---oMEo-BBoMBBB-EB------o--EB---X-E--X-------?X-oBE-?---------?B?E-X---X-------?----E---oo----B---ov
-o-----------o---XX-------------E---X----EEoB---o---E?-o------------o--X--o---------?B-?oo-X---o----BMo-o?-------?-X-BoXo--------B--E-o-------?-----?-M-o--B---------M----M---?-MME?-?----------o-o--MMf
-------------oB---------------------E---BMX-oB--o--EM-----X-?X----------------------o--B--M---M----XX--M-M--E--o--oE-----EX--------ME---o-------E--E--E--X--B-----EE-oE---?-X------o-o---X---M-oE---Xo?f
----M-------------XB-------E-------E--BX?----oXo--EM-------E--X-----B-EE?-XE--M-M-??-?-M-EX---------B---EoX--MB------o-?-------BM--?--B-M--ooXE--------E---B-------?-X-----E--?----------B-E-?-------M?f
-o----?M?MB---M---------M?-M--BBM-M-M---M-oE--o-E---o---XEX-------E------EX-------X---XX-------B-----------M--------------B-------X-----?--MX----B------X?-BM-------M---BEEM--X-------o--B---XEEM--?o--f
-X-X-----E----X--E-XX---oXE-----M-X----------M---B?M-X-XX-M??-------------XoEo-?------?--------o---XM-EB-B?o-------o----oXo-Xo-?---o--BM----o---E---?MM---?--?--------X---BoM-XE?-----B-M-XX---E--?Bo-?f
-X--o-?-----------?-M-oE---------B-E?---XM------B----?---?Mo-----E-?----X-X--MM---?E??-B------?--X---o-?--E------M---X-?--?Bo-?----B-??XM-M--E---X--B-E-X-XE-----------MM--------------E---------MMX-E?f
m------T-?-?-MM-ME---BE----MME---?----T--------EMoB-o-o?--MB-BTT-E-X--BT------B------X-?-MoX----------B----------?-----------B---o-o---M-X-B--------MEB---E-?---XX-MT-----TT---ooX--E-B----XBE-T----TM-X
XBXXXXX|XXXBXooXXXXXXXXXXXXXXXXXXXEX?X|XXXXXXXXXXXXXXXMXBXEBXX||XXXXXXM|XXXXXXBBXXXXXXXXXXXXEXXXXXBE?XXXXXEoXXXXXXXXXXoEXXo?XBXXXoXXXBXXXMXXXMoXMoXXXEXBXXXMXXBXXXXo|MXXXX||XBEEXXXXBBXXXXoXXoE|XXXX|XXX
