X------------------------------------------------------------------------------------------------------------------------------------------------------------------------------------------------------T
E------------------------------------------------------------------------------------------------------------------------------------------------------------------------------------------------------T
-------------------------------------------------------------------------------------------------------------------------------------------------------------------------------------------------------?
o------------------------------------------------------------------------------------------------------------------------------------------------------------------------------------------------------B
M------------------------------------------------------------------------------------------------------------------------------------------------------------------------------------------------------B
?------------------------------------------------------------------------------------------------------------------------------------------------------------------------------------------------------X
X-------------------------------------------------------------------------------------------------------------------------------------------------------------------------------------------------------
M------------------------------------------------------------------------------------------------------------------------------------------------------------------------------------------------------v
E--EE--X---------B---E-o--------X--oM--------M-M--E-o-----BMBEX-MMX---oE---M--MEB--X---Xo-B--E-----------X----M-M--E----X--??---B---oM--E---o----M--X-?X------E-E--M-X---------------M------MXX---------
------M--M-M-o-XX------o--B--------EooMM----o-X-----o--oM-------X-oB-o---?-X-B--------E-E-B-o--o-----MM-o--M-E-E---------BME-E-------X------E---?--oEo-X--EB--?E----M--E----ME----X---X---X------------T
|-----EM-o-B-----BoEo-M--------E-XM--M--------o-X--X-X----EX---X?-o-MBX-?----E?-------X---X----------MM----B--B--------M----------E---B---oBo----------?---------?-----M--X-E---MM-Eo?--X----M-E-?M-B--X
--?--o?--E---o--X-----M--------------?--MX--X-----o----B-?--B--?-oM------E-o---------?B---?----?B---------------o-X-------?E-B--M------------o----------XM-E-B-EE-E-E--M---B-E---E?---B---E-----o----o-?
o-X--E---o--MEoE-E-B-M-?---E---------?---E-X--o--E------o------MX--o--------------BE-M?--E-------?--oB-?--?Xo---E------MXM-----B?-oX-X?----EB---------B-----X---o?---X-oXE-o---B-?--------E---o-o-o--X-X
T-?-------o----------oX---o-M-X----X-o?--E--E?---o--oEM-B---M?-------B------BM-M-E-MEB---X------B---X---------X----o---E---XM-XM-----BE?------?-------Bo?-M-B-Eo-E---?-?B-------E---o--oM--X--XM--MX--oE
m---E------BB---X--X---o--MooXB--B-BB--M---XX--B------Xo--E--------?-o---o--M?-o---E--B-B--M-----EE--E---M--M---?-----E--XB?-BoEX------o------?-M--o---X-----?----------o-------X-?--MBE-X----EB----X--B
X--?-o-?---XM----B------Eo-?---------o-B-------XMo--o-----?X-?M-E--M-----M---o--o--o-E------EBo-?X-----X--X-X--?MB--M-E-oo------M--XEE----E?M---?-----X-E----B--B-B-o-X--X----B----M----M?---o-E-----?oX
