-o-----------M-o-M----o---EM??o------X-o--X-?-?--o-o-M-?-------o---E-B---M-X----M------X---XX--------X--BoEooo-------M-?-----------?-o------?---------B---Mo-----Xo------o?----------X-E?--E-----M?-----
-X---?M?--?o----E----------E---?--------------?--M--------M-----X?--------E-E-------XX-B-----o----------B--B-----XXMo-----XMoX-Bo?---X--------XB----o--M--MX----------XMB--------B---E---o-E-M-?-?---B--
-----M-X----------EXX-oB-EE--EBB--EM-----o------o---E---B-----?----o-ME---BX----B---M-B---E---E---X--?-?---M------?--X-----------B--M--B--?M--X??---E-B----?-E-B---BB-------o?--oX?-BME---oX---ME--E?E--
-----EX----B---EEM-M-----M--?----o?---------?--B-M-----?EX-B--X-----ME-----M--X--X--?M?--B-E-E-?-?--B---M--X--------E-XB-o-------------M-----?B-----o---M----------X--------E---------B--E---oE--o---XE-
----------M-B-X---o-----??MBo?MXBE-----?--?-o----B-M------E-----E----o-B?B------?-B-E--oM---oE?--X-------?---o-?-BM------oM-B-M--Mo---XE-------M-----------Bo--M-------o---BX-M--?BEE----o-X-----E-M----
-B------X--M-oB----------------B------?-----B-----M--?XM---BB---BX---E-?-BXE------B--Bo--?--B----M-----?-B----B---?---E----MBB-oB--Eo--?-X-BE-??-X-----?M------------?----o--------X---o----------?-----
-------X-MBM------oo-B-EM-BBE---BE---M--o---MB-E-X------E-B--M-----o-?----?-----o--o-X---??-EXE---B---?E----B-M---EM------E-EB-MB----o--Xo-------X--BM---o---X--?-Bo-------B--E--B-E-MB--?--M-----MoEB--
---B--M--?---------B-------X---ME---------E-X-M----o--M--X-oXo-----o----B---X---------M------o?o-B--E--B-B-B-o-----M----o-----------E--------o--M---o-------o-o---B----M?-?------B---B-----XXo?--B-----v
------?---oX-E-X-----M-X??--------o--X-?--EXM---B---X-----B---X-------E-X-o---------Eo---EX--X-B---MME-------o---?--?-E----M------X--?-??---------oB---E-oM------X---E--?MXo--M-----BE-------M--?------f
-E---M-M--?-M---------M------o---M--------?E----X-E--E-----E-----o----oBEME---E--E------B?X-o-BBX--------B-M--------X----o-o----XM----X--?-?oM--?----------M---X--?M----Xo---X--?--E-MB-o-?-oo-B--X-B--f
-B--------?M-----XM---X---M-X-Mo-----oX-?B--BE-----BB---M-BX----??---B--M---E-X-------X--?----o--?-M-M----------E---E--E---oB-o-------BB-M----M-----M-MX-X--X-?X---M--X-?----X---o--?-MB----M---B?---?-f
----o--B-MM-?---BX--------------Eo?X--BMB-o-E---------oB-E-----Bo?--------o-------E------XB---?---o---??---E-B-X------B-----------M-----E-------M-------E-?M-?--o-----M---EB-------B---X--Eo------BB---f
-o-o--M-------?B----?----?-----o-oB-X-o----XM-----?X--ME--------?M--E--MX-o-----oE---M------?-MMXMo?Xo--M-M-MX----X-MoM----------o-?--B---E----------XE--------ooX-------B-----XM?X--------M-?Bo-M--M--f
--?--------------?M-B-?----?oB--X-o---?X?--------X-M-------Xo--E-B--M--------?X--E-XE--B--------------?X-----B--E-E-oo-----------B-o----E--------E-----?-E---B-----B----ME---X----E--------X------Xo---f
mE--o---B--EEME-M--o---EE--B?--o???--?--------XM-MB-----M-------E-B--T------T-M----oMT--B---EB---M-ET--------B--o--?--T-o-E--o---MXB---X--------B--X?MM-M-E--B---X----X-Eo-----?--?-----T--T--?---??-XMX
XXXEXXXXXXX?XoBEXXMXXXXXBXEXXXXoXXXMXoXXXEEXMXBXXXXXXXEoXXXXBXEXXXXXX|XXXXoX|XBXoBXMX|XXXX?XXXXXooE?|X?XXXX?XXXXoXXMXM|MXXXXXX?XXoEX??XXXXXXXXXBXXXXXX?XXMXXMXoXXXBBEX?XXXXXBBBXXXXXXX?E|E?|XXMXXXBXXXXX
