----B-EXE?XXXEM-B-XX-XE-E----?EEEBXEEoE-XXE?X-XX-Xo-EXBXEXB-BE-BX-X-XXMXEB---XE-EBEB-BB-EEXo-?---E-oEEoX-EBX?-E-EX-XB?EX-B-o-BoXo--B-B-o?-M-oXEoBEXB-oXE-o-EXX-?o?E--MooE-oXB-XX-?-X-EX---E-XE--EBMXXME-
-EXXo-E--E-oXEE-Boo---EXXBoXXX-X--Boo-E?-XXE----B-E---E-XM-XXE?BoMEo-BB--X?X?MoXEE---BoE--ooXXoX--EEEM-XXBB?-?---XXEo--BE-E-EEE-EEBE-Mo--EoE---XME-BoB-B--MX--EXEX---ooX---o--E--oX-EX---XoB-BMXXo-?ooo-
---?--XE--E-X-M-EEE?X??XXMoo-E-EXEXXEEEBX-MM-X-o-oMEE?Xo-M-XXBXXXoE-X-EBEXBM-?E-BEBM-E--BXoEE--EEXBXEE?--BXXX?XBBBEoEE---oEEXE--B-BEEB-XBBXXE-X-X-BXE?-E-ooXXM-X-o-----oE-MXo-E--B--E-XEB-o-XoXE-BEEX---
-oX--E-o-oXXMBXEBEB--ooX-BX-XEB-MEE-oBMEo??---BE-B-EX-o---oEBEXB-XX-o-EEBo-o-X--EXoXXXoX--XMXXB-XXXo---EBM?XBoE--X-o--oEXXXE---oEBX--EoX--X-BXB-EEXEo-Xo-E-X?--X?EEEMEXo--?Bo----BoX-M-E-E-X----o---XXX-
-EXBX-?XBBBBEEE??Eo--XEEB??EX--X-XEM--XEo--oX-EoX--EX--Xo?-oo--X-E-?EX---XXEXXEEX-Eo--XEEXE-E-EXX-XoE-B-M?XE----X-XX-EoE---XXoXXXX?-oE-BoX--oEBXXE--XX--XXEE-oM-M---o-?EEBoX-EB?---Xo-E---?BE--X-?--EEB-
-EE-XEoMEEEo-EE?Xo-XXXEEMooE?BE-BEEEX?oXXX?-EX---EXo--X---oo-E-Xo-ME-XMX-B-X-EXoXB--EXB-?-?XE--?XMXBX--XE-B--?--Bo-EEM-E-X-XB-EMoMBXEE-M-?XEX--Xoo-BBBX-M-EE-EB-o-o--BXoEXEo-E--E-BXoBX-EX-M-EEXX-?BBBE-
-XEE-X-o?-X-B-oE-?oMX-E-BXXXEB----BoEBoMX--oEE-oB-XXX-B-EMoEMXBXXEoX-MBoB--EBXEo-XME-E?BEB-E-MBX-Xo----XXoB-B-ooE---oXBE--XB-------M-?BM-oE-XE-oEo?-X-X-B-X--X--oMXEEB-oX-BE-EE-X-E-Bo--MB-oE-BMX-EX?EE-
-ME-o---o-?-?XMo--EE-?EEM--EXX--X-X?EBXEBXXXXo-XEXo-X?----MEBBooXoEEX-X-Eo??XB-EX---MB-E?--EXX-o--?X---XoXEXEoXX-EX-Xoo?MBM?XXXBXM-EB-Eo-oB--EoBE-EMo-oB----Eo-oXo---XXXEBXEXE-X--EEBEBEXXEE?o--?MXM---v
---EEX-oEXEoo--XEEo?-EXoX-X-BX-EEB--oMB-BoXEE---X-E-EEXE-E-XXoMo--EoX-BEoEE----B-BE-XXXBo-oB-oB-o-XM--X?o-EE--XoEXXEE--E?Bo-E-EoE-?XX-EoMBE-E-B-EoEo-XXME?ME-EooMBX-XXEX--XooE---oo----EE?-MoE-E-Xo-?-Xf
---X--XX-EMX---E--XoEEEX-E-XoE---oBE---E-XB-XB-XE?XXBXo-oXEEEMXXoBoX-X-XXEXE-XMB--XBBX-E-E-o-oXoX-X-XEEEMXEEX?--o-M-o?E-MoX-X--E-XM-XBM--XBEBBB-XMM-XEB?BoX-XE--X--BEEo--XE-B-BEoB-E-oEXBE-XB--E?Eoo-oBf
-o-E-XEoEEXE?Eo--BBXE---XEX-o-o-B-X?-B-BE?-?E-X-o?--?--EXoXX--XBo-EM-BXBoBXXMXB-Mo--XBE--E-X-XEXX-X--XXEMoXo-X-o-?X-XXEX-E---XEoB---oEEB-MX-XMXB-MEB---Xo?--XEX--XE-BMXo-XME---Eo-EB--XXoX-ooE-BoEEEEBEf
--BXX?-XXEEEXoXBoXBXBo-EM-BXB--X-?-XXXXoXX--MM--o--XM--XB-E-XoEXE--XEX--BoEo-E-XB-o---X-BEoXB-BEEX?-Xo--EX-X-X--BE-MEBE-BEo-?XE---Eo--o-X-EXX-o--BEEM-EX?oXoMX?E-XoBEE-XXoXXBE??-E-EXo--E?-MEo-?-BE?X--f
-EoEoooo-MEXXBBXBo-X-oXM--B-?X---BE-EE-B-MXB-oB-oX--E-o-XXMEB-oEX-oEEXB-o---oXE--EX?oX-E-X----EM-oBEEX?--E----EXEBX-M-XB--E--?-?--X-EE-X-?-XE-E-EX-oXX-?XoEE-XE-o-X?-M-XEMXEXEoEoMoX-BX-BE-E-XMXBBEMBMEf
-E-X-?EXX-EEX-XEB-XXMB--X-MoXX-EBBEE-EEB?B--EE-M-E-EE-BXBXo--oB--E?EEBoEX-oE-BBEB?BBoXoEBEMBo--?--X-EX-MEXBoXME-E?MEEoBo-M-E-X--M-E--BXo-EBXEE--M-X-M--oBX-BEM--XX-XEEoXXEBEX-M-XXBXMo?XXB-X--?XXX-o---f
mE?BX-?XB?--E--XX-EEoX?-XXo--XX-B-EXMoMX--E-XEoo-XXE-----E-BoXXBB---X-o-BXoooEo--X--E-X-XEE-ooXBooXXEX-E-BoEBBoXBEXoEXo?-X--M---B?-oXXBEoX-EEE-?---E-E?-E-oX-BX-EBXM--EEX-X-B-oB-?XEM-E--EEE-Bo-B-MM-?BX
XM-EBXMo-XoBoo-M?XoBXXo?E-X-EE?XX---X-X-BXXE--EXB-B--oEXXEXBEX--XXEX---X?EBEEXXEB--E-BBEMME-X??BE-X-oEX-X-o-B-?BM-o-oBEX-M-XEXXo-X-EXE-EB-EEX-EXBo-EooEXX-EX--EBEME-MoX-oo?oEMXE--EXEM-ooEBXoMBBoXXEX??X
