-XM-oEBBEXBE-??-EoE-XoX-X-E-X-E-BBEMBX---?XE--BXoBMB--X---oX-EME--X-B-E-EX-?-MoEXBEXXX-X-MXB-M---oo?EXEM?X--XX-?-oXXEE--E--EoX-BX?EX---oEEEME-?EM?E-MoEMoX-E-XE-EEXoX-E-oXXoBBooEoEXBX-EXEE-EXM--?X-----
-XEXM-EE-?B--XEXEo--B--E-E-X-oBEXB-o-XEX--XEBX-B-o?M-XB-?M-MXXMX-EXBBEoX-X?BX-E-M-EEXB--BEE--?X--M-?--EEXE-EEX-M---?oE?XEXX--oEo-X--XM-E-B--?EE--XBMEXBX--MoBEEXBXM---X--o-E--M-XXX-o-o--oB--BoE--?EEE--
--oEXBXoB---E?B--oXX-o?o-o-XEX--o--EXXo--E-BXE-o?--X-X--X--MEXE-XEEX-XoEX-oX-B-MEME-EX?XB-BE---M-X-XEE?X--MXX?MEME??XM-MMEXXo-EEoEBEXMX-EXE-B----MXoBXXoE-BXXo-XBXMEoE?-MEEXB-EME-BXE-oX?EE---?B---??E--
-X?X-EB?---oXo?X?BXoX-X-BoooXX--oE?---M-o-??BE-o-MEEX-B-Xo---MoE-M-EEXBE-ooEX-XEM?-X-oEX-oXoBXXX--EoBX?B-B-oE-EBE-B--EXX-E----?X-EEo----o-X?E-XoE-EEXoEXX?B--B-XE-M--X--o-XoEXEEE-XEX-XXXoEBB----Bo-M---
-E-E-EX-oMEXEX---EBBXoEBXMX?X-oXXX?-XX-X-?B--E-E-XX-?MXEEXEE-----EBMEoXXE--X-oo-B-XEME-Xo-X-?EX-o?EB---EXB-o---E-EX----??XXX-EX--XE-BXBBXX-oXEEXEE-EE?-o-o-XXEB--EoXEEoXXBoE-EEBEE-BE-X---BEo--BoEEEXX?-
--BX-XBB-XM-oXXBE-XBEEEEMX--XXXB-XXX-E-MB-XB-XMX--EEE-E-?BBE?-X-EB-o-X--oB?E?EBBXoMX-X-E?M--X-E-EBBXB--X-oEEX-XEXEo---B--MEM-B?EEE-oE--Eo-MBE-X-X-XEBoo-oo-XXE-EXBEXBoBX-EoEoEEMXEBMXE-EXXB-XEXBME--oEo-
-?B-XBE-B--Eo-BXEEX-E---BEMooBXXXX---EMXEB--EB---EBE-MBB-X-X?XX-XE?B-XX-EX-E---EB--BX-XMEo--EEBMXXXXXEX-X-XoXXM-M-MX?BMX-E-E-EM-X--BME-E-XoE?----oBBXMXXBEEXoXXo----E--o-EM--X?--E-EEX-XE-??-MB--B?-B-X-
-XXXBXEXEE-X-EXoo?oEo-E-XXEE-EX-B?XE-XX-M-BXE-E-XM-XEM--M-EEX-E-M-BE--E---XE?E-XXo---Xo-BoXEEXBXB-oE--MoXMEMXXEBE-B--oE-E?oXXMX-XXB-E-EXX-BEXEXXEXE-EX--B-XoXo?B-E?BX-BE-oEBoXX-MEE-B---BoXoo-E?EX-BX-Xv
-X-XB-BEBB--o-XXE?BB-EX-oEXEo--M-X?BEB----XX--EB-XX-EB-EoXX-XB--XoXB--EXX--B?-E?XooX?M---X?o-oXX-B-XMBBE--EEo-E-o---E---XEB?X-BE--X-EE?---E--X-EBX--BEB-oXEoE--EEE-oEoEXBoBXX-E-EE?Eo---Xo-?XXoX?oEX--of
-E-EXBXEBXB??EEB--o---M-EoM??oEEE---XX-X-X?-oXX-oMX--BEXoX-oXX-EXM-XEEB-?EB--?MoEX-XXXBEEEBE---BB-o----BoXXEEB-B---E--BEooBE-?-?E-XXXoE-EBBX-BMMEo-E-oEX--E-XX-XEXEBXXM---XEXEXEoXo-X-X---X-XX-o-X?-oX-f
-XE?oEX--?XoBEX-?oB-Eo-XX-E-XoEXEB-XBo-MBMEEEXEoB----XXEXXX-EMXXE-X--XBXB-EEBXEX?XXBMEM?oE----BEXXXX-X---?oo-E-oBEXBMBXo-BE-XoEXX-oEB-XE-?E-EE-XBEooM-XEXX-MEE-B-E-B?X-MXMo-X-EXEBXX-X--XXMB?--o-MXoEE-f
-?-XoBEXoBXEEX-----EXBB--X-MEoo-oo-E--E-EXXB--EM-?BBEE-??EXE--BoB-E?--EXo-XoM---oBEMEX--XEBXB--B-EX?-o?EXo-EEXM-E?--XXEo?--X--oXoBE--X---o--XXEXB-EoXX-EMBXoEXE?-E-XBoE?oB--Eo-oE---BEEB-EBXB-o-E--EXoEf
-XEM-X?EoXB-X?-XXXEEEE-XoBXBX?E-E-E-EX-EMEEXX----EXoMXBE-oX-EEE-Xo-B----BX-EEo-o-o-EM--ME-XEXMEEooEBX--?BX---BX--X-?-X-X-X-XXM-Eo---BEXMEXXB---XM---?oM-ME-X----EEE-M---E-MMM?X-BEMX--X-B--oE-M---oBB-Xf
-EE--BEXEE-Xo--E?X?o--M-EEXEXo--EMX--XXXBEXE?---E-?oEBE?-oEo---XoE-XEEEXEB?EX--E-Xo-EXEXBo-B--E-X?XE-X-EEEoXXoXEoBXB-B-EEX-o--EEB-MBoEBE--XX-X-BXMX--E-EXE--o--X-EEBXo-M-BXBo-E-X-EXoEEXE?XEXE-Bo-MX?--f
mE----XEE-B?BEX-XMo-X-M--EX-MX-EXXo--X--XE-XoEEEXoo-XEXoE-EXX?-XE---X-XEoXXE-XEEEE?o-EBM-XEX-B---X-EoXBX-BEXXX?-B-ooX-?-XEoXBXE-?EBBX?-BB-XEB-E-E-XEX---MEE?-XXE-X-oEXE?o-X-M-XX-XB-B-B-oXX-o?-EE-B-oXEX
XM-?-E-X?-X---ooo-EX--BEX?-X---X-X-EEoBMX--X-EEE---XXE-E------E-X-XoEX?--X--XBEE-EB-E--XXEE-EXXo-B--X--?--EX-X-ooo-X-MX--?XoB-EEE-XEM--?-oMXEM-?----EX--?-X-o--X?MXMBX?E-EB-?-XX?B-XX-?-XX-XX-X---MXX--X
