--XMoE-?-XX----X?BE-oXXoE----?BEoBoEEoXEXX--MXE-EXEXE-X?oBEEEE?--o-EE-oE?Eo-EoXXMEBX---X--oE?X-o-?-E?XX--?--?M-EXXXBo-EooBE-oXoM--BXE-E-E-B-o--BBXM--BEBo---X-oE-o-E?-X?XX?EX-E-oXoo-X--XBEo-E--BMXEBoE-
----Xo-XXX--oBEX-XBEEoEX-XE---o-?EE-oM-EX-XB--EXoXBE-MXBEBX-oB-XXoEoME-?X-XoE---oX--Eo-XBXEEo-oooBXooBo-Xo-XM-B?E-oMBo?-BX--MBBEB-M-XMBXEoX--EBBoXXX---MXo?E--BXXBXoo-E-M-E?E-XE-EEXXEXEXo---?-X--oEEXo-
-XEBoo--Boo--X-EB---oo-XM-EX-XoX?-o-----EXX-EEE?-EEEXMEMEBo--EX-E-BBXM-Xo-BXE--?E--BX-BXMEo--EoX-BM?EXX--E-X-XBM?X-oM---X----?EXX?EXE?Xo--BEX?--??EX-BoEX-ooEoXo-XX-B-BEBB--BE?E?MEoEoXX--XB-MXX-Eo--EE-
-E-XE--X-XXX-XXE--E-B-?E-Mo-EE-oXEoEEXEE-XE-XB-E?----Eo-B--EXoMXM-E--E-M-Eo--?BE-MXX--EEXo--X--BMBXEEEB-o-E-E-oX-X-MXBX--EMEXXB?MX?o-EB-----XXEE-M-MBXEooXEE-XEXM?--X--o-E-MB-EXXBE-EXBXE--XX-XEEX-BXX--
--X?BE-?oX?-B-EB?E--X---oXE--Eo---B-ME----oo-E--EXXME-XM--?E?EEBEEX-----X-XXEXB-X-E?BB-M--XM-E--BEB-o-EE-XEooE---o-MEo?MXX-E-XM--BMXooE-MMXEBBMEX-?E--Bo-XoB-MXoEB-BXXXX-XX-EMoX--Eo--EXXXE--EX-M--XoE--
-XoEBXXMEBXEXEoXXB?XB--EM--M-B-XBEMXBX-XE-BX-?EX-X-EE?-XX-M-BXXMEEX-?-B-oX-EX--Bo-XEXXoEXEE-oB-BMX-ooB-?BB--XE---XE---XM-M-o-E-ooM-E-BEoEE-EoBXE-M---EBBXB-X--?-Eo-X--M--?EMXXXo----EoBXEoEXXX-EM-EoMEE-
-oo?-EEX-EEoM-?---oX-oX---B-oX-XB--?XBXX-B--BEME--EX?--XEXEoXEXEEEEXBXEo---?XoEBoBXXBX---XoE-X-E-B---XXMBoXE---XMEBX-EE?-E---E-M--?-XBE--?XXXEX-oEBBB-oXE--oXEX---X-oXEoME--oXoo-MMX-XBXEXMXoXE?o-EX-EE-
-X---?-EX-EB--XMBE-XEEB-oBEEEB-oBXXMBEMEo-E-X---E-BX-EE-EEB-X-?EX-E-EE-oEXBXBoXoEBXEXo-EE?-o---XEX-oE-MEXEEXE---X-oEMX---BoXB-EE?E?Eo--X-?oo-BMX---Xo-XE--E-XXMooEMXXM-XooM--?XX-XXEBXEXXM-XE?---XX?-BXv
---BE?X-EEBoXEEXEMBMB--o?XBEXM?XEoo?Xo-E-EEM-B-oooE--oEoMM-BEBBE-M--EoB-E--?X?EM-BXoX-oEEM-EEXMXX?M---EXEBX-BE--XXBX?-E-o-EXEo-E---EEXoEEoEXEBMo-XMXEE--XEXEEB-XX-EBX-?EX---XoB?o----BEoBoXEB?EE?X----Xf
-EXoB-EMBE-E--X-XE-MEXX-----BBBME-XB?BEBBEEXo-X---X-EM?XEXE-E-EBE-EX-o---oooXXXM??-B---EXMoX--Xo-B-X??E-MEXB-BXMXEBEXoB-o-oXB-XME?o-E-XEB-XXEXXEXE--BE?BEB-X?E--oX-oBX---BEE-EEBBXE-B-X-oEEEoMo--EoEEE-f
-o-E---ME-o-EB-oX--EE-X-X---BEXoXE-BB-E-X-X?-E?-oB--BXXBMXM-BBE?o?-X-MoB---E-XXXEBBXBX-EEE--o--EEo--XM-EEXEBBBE-XXX-EXo-BoXEB--o-X-BXEXo-E-E---BXEXEX-MXEXXXE?EBo-M-o-?-MEXXE-EE-MM?XBo?-E-EEoX-EXE?M-Ef
-BX--oBB-XX-oE-EoXEoE-EXB----MXEoBEMEMEoEEEEo---oEE-MEXX-EE?-B---XXB?EX-EB---X-E-EX-EoXX-BBXXXoM?MXX-BM--oBEXX-?X--B--Eo-X--ooB-M-BXoEM----XX-EoooX-??EXMX-MEoEE---E--EBE-XE?-BEM-E-MX--MMoX-?BEXX?oE--f
-XE-E-XB-oE-E-oXXXXB?E-Eo-E?BB--BX--X?EE-X-XM--o?--XX-X----EEoE-BoM-E?XXXEBXBXX-BXX-X----BX-E-BMX-X-BBoB-X-oM--B?o---oX?-E-X?-X-Xo?EB---E-MBX?XXE-E-M-XXo?-X--XME--EB-oX-E--o?E-EMXM-E--X-?-BM-E-?EXB-Ef
---EXBX--E-BMMXX?EEE--?X--?o-XX--XoX-EB-?E-?EoXMBEE-BB?oX-oEoBE-oEEXBEoEEo--XEXX--X-E-EXMXBBo-BX-XEM--X?XEX-XMoo-EMEB-MEo-XBEE-MX---BBEXE-B-E-E-MEBMEEo--BB-oEE--MX-E--XX-XXM-oXX-X-EoEBB-X-oE?XX??--E?f
mo-EXEEoBX-E-o-XXE----XEXEE-EXBE----E-B-BEMBMXME-EoEo-BXB?-X--XoX-Xo?---MX-?-E--oE-XXE-EXEEo?MB----o--o-o-E-B-E--oEX-EEoXEM-E-EXB-E-oEoEooBXB?X-M?-X-Eo-XXE?-XEoEB-Eo-E??----XXo-?oXBEXX-E-E-E--XE-B-E?X
X-EXEXE-EoMoBE--oE-o--BME--XBB-Xoo---Mo-X-?EE--EXEMB--EBEEoX--EEEXXEXB--oEEB??-X?BBE---E-BXXM-XX-EME-EXXXEBX----o-XM?EX--?EX---B-oM-BBX-B-XX-XXBXBX-EXB-BM--BEX-X---E?-BX?-E--X--E-XMEEBXBBE-XXEB?E-EXEX
