?oE-M?---BB---?---E---XXM--------o-o-oE--B-M---Eo-?EE---XM----?---M---EE-E--------Eo-B-XB--X-----o-----------EE--B-E--Eo-M-----?-?---o--M-----X---oB------X-?M---oE--B--oE?-----o--M----o-----BMM---B--M
EoM------o-o-E--XM---------?-M--o---------??--------X-BE---o----M---o-B--------------BoBX-B?----?E---M--M----E--X---B----B--B---EE------o-E-M--o---------XE--?-o--------oo--Bo--B-------o?XEM-EM--M----T
E-M--X-?X?---MoX----E--M-X-------B--M--------B--?E--B?--Mo---E-M-Eo-o-M---o-MX----o-----o??-?----B--XE--------M----M-BEo-M-E-M---o-E-----?--B-------?-M---X---EB--?---X----EM------M----?------o------B?
M--MB-EBE-----M--------o----?--E---?---o---------?----oo--o-----EB-XX-M-XoX-?-E----B-X-X-----o--B-XX----B-?--o-B--M---X--o--?---------o-E-BEB----?o-M---o-B-----E---o----------o------E---M----o-o---o-M
T------------X--E----------o----E----EX?----E?o---B-----B---M-M?--B----M----E-XXE--E----o-----------oo----E-X---E--X----X-E----?E--?--M-------M------o-------------E--MM---M---o-?M-E--X-BXo-B----E--??B
|?-o-----X------------?-E--B--oE-E--M--?---X-----B?---X--X?-------o--M--B-o--B-X???---E-------------M------X---Eo?---?-BB----E---B-B-E-----?-E-?o-------?---o--XX-----E-E-XBE-M?-EM--X-BB--?----------E|
EB-o----BX----MM---M--X---BX------------------X-M--E--MX?-E----M--X-------?-------?-EE--XE--B-----o---X--E-X-M---------XBM--Mo-?----??--M----M?----o--M-o-X------------E-M---?-----E------XXoo--------XB
EoME?X--X-o-oB----B--o-X--M--B-X-M-X-----M--M---oM-------?-X-------X------M-------BX?--------B?----EB--o-----------o-M---MX-XB-?--E----E--o--------------Mo-E--o-M----B--B---X-----X--?----o-ME---X-o-Mv
o??---XoB-?oB?---M-----------?------?---X-?--X---o-E--o----XB?-----X--M----?--E-------B--oB-?-?---E--------MM?----E-?---o--?--oE-E---EE---o-EX------M--B---MM----M---BB--o-B----X------------o-M-------X
B--------oX?----?----?------M-MoBX-?---EX--?---MM--BE----X?--E--?---o-M----X--o------E--o-X-------?-?E---------M-------------------X----M----Xo-------------?EB--X------o--XB----E---M---B-E--?B?---o-BT
|-EXX--MB----E-X----o------X----X--X-----Mo--X?--oBXM----E------??---E----X-M--------E-?---oB-------oX-----BX--BE--E-E?-?M---------o-B---o---B---------E?--E------?---X---o-E-------B---X----X----oo---X
---o---------M?--M--B-----X-oMXE-------?---Mo----XB-------?-?-E------------E-E--BB---?---oX----M?--X-E?M---M-B--B?X-M---?-?---------o-----M--E---X---------EX----B-oM?o------BM-Bo--M-X---------E----X--
B--------M----?-B----B------X---E--------E-EM--MoEX----?-oo-----o--o---EMo-B--M---o-----??-------?----XX?o--B---------o--o-X-E---?Xo--Mo---------?-oX---Mo--?-M-----M-----?B---M---o------BE-B----X-X--E
oo-----E-----B---o--X-?--MXB-----X-BE----o-XoB--B------X--?M--M-X-BMB-?-EB------BM----E--B------?---o?-X-----B--X-?B--M----MX-------X-----Eo-E---------B----------MM-X-X--?---?---B---------B---?----X-?
m---EE---X--X---------BB---M?E----B----o--B?--------?M--E---M--E---------B--XBB?E-o--B---M------o-------M-oE--X---Eo----oM----X-----E?-E-X-??----------------Xo-X-?-----E-----X-E-o-X-?-X--E--E?-------o
XXXXXXXXXXXXXXX?EXXBXBXXX?XXXXoXoBXXX?XXXX?XXMoXXXXXXXXBXXXXMEXXXEXXEXMXXMoXXXXXXXXXXooXXoXXXXXXXXXXXXX?XXXXXXXXXX?XXXXXMXMXoXXXXMXXMXEBXMoXXXoXXXMXoXXXXXXXXE?BBXXXXMBXXEXXXXXXXXXBXXXXoX?oMBoXEXXXMXXX
