XB------o------BXo-B-----M-------M--B-X----------MBEBE--EE---?B-E?---X-?--M----XMo-------E--E--B-E--o-E-----o-----------B-X----X-----M-B--?-----E--------E---XM---B-----E-----o--XEB------X-?----M-?--o-
EMo-M---E--?--M---?-----o----o--oXBX-XB-E---o-----EBM-----B------??------------E-X----X---?---B---------M----X----EE-----B---------B---X-M-o-X----o------Eo---E?-XXM-XB--ooM-oE?---o-o----?---M-o--X---M
T------o----M--XM--E?o-X--XX---------------------------B--BEXo-B-EE------oEM----?-?----B-M---?M--E----?E?-E-MBX---E-----E----E?-B---EB----BM-B----E---BX--X-?o----oB------?BEoXE------o----------------o
-----o-X-oE-X-?-?----M---?--M---?-Mo?--B--?----?-----o--o-----EE----B--oM-o-------?-?---E----B--E------X--??MEX--?MB-o-BB-------------------EM-?-oB----B-----------M---?--Eo-----oB--X----MM---EX??---?X
X---B-oM-o-?---E---M--------EEo---EB-----X--?------M-----X--?---E--o?--------o------X?B----o---------?-E-?B--------o----?-MEXo-E-M?BX-X--M-----X--MM-oo---?---M----Mo--E-MEEX??-?M-X----B-XE--M---o----T
BE-o------o-BE---X-M---?o-----o--------oB-o-BE--E-B-B----B---B--MXM-X--BE-o---BB---B-o?--BX---EMM------?B-X--Eo--------E---------E------B------X------M-M-X--B--B---?--M------M-o-X?B--M----M--?-oEX-XE-
|-E?E-BX----X-B-BXo--X--?-B-E----E------X--B--?-M-oB-----E---B---?---o------?-M?-----?--B-?--?M--?----E---o-M---B----EE-----o-XX-------------o-o?-----?--M-------E--------------Mo--B---X---?XX----?---X
M----E-B-----E--B--M-X-------------M--M--XMX--E-----XX-----B------B----X--M----?M-----M-MM---o--------M--------?----ME?B-?XME-EoE-M--oM-X--E--------M-X-Mo---o--?E-----E--E-E-B-B-----oE---Xo-----o?EM?v
|o-B--------?----M---BM-?-MB--M----M-----B--o------X?o---?--?oX---E------?oB?-?-----------M--------------------------M-E----Bo--X----X--------BMX---EM------?o-B----?-o--M----E--BB---EE-?-------M---M-M
B----------X-o----Mo--?----X--o----?---M?B---M---?--------?-M--?-------------------Mo--E--E-----E?------X--BM---MB---E---XBB--EM----B-M-M---E---------XBo--Mo?-----------E-X-X--------XoE---o----------o
?---M-E----E-----EE----------o?---M--B---?-B-o-B--B-o--EXE-----o---B---?-?MM--X-EX?M---oX----M?M-X--------?B----XMM---------M-----------------------B-E-o?-----------BM--o------X---E-X-B-X-------E-?M?T
E--M?------XM---------o---BM----M--o?--o--EB--M--?--oM--?-----?B-----?---B?--BBMM---?-oX----M----o--X--------o---X-----------?oXE-------?MB--E-BoBXE---------o-B---M??-M----------------B-?---E?--EBM--E
--?--?-M-------X---E-MM--------o--M-o?--E-?----X----------EM??B?--E---B--XX--X-B-----?o-B-o?--B---?-BBo-----?-----?X---------M---?-E----o-?--B-M--XEXM-X----X-EB----o-o?------ME-o-----?---------X-----?
o-B----o-X?-B-EB?-E---BM---------B--oX---M-?o--X------EM---MX------o--X------?EEB-B---EM----------?-M-?----X----B--Bo---E--M-B--B----------B---E-X---E----B?oE---B-----?--X-----E-----E----M-o--EXo--X-T
m--M-M-----?M-M-E----o-?--o------EM----EX--o----------?-E-----o-X----E------?-----------?---?o---Xo-X-o-M--?------------M-------------o------X--------B--EXE-B-X--M--BX-M-B-?----?-E--------M-E------B-?
XMMXXXXXBMXXXoXXoXXEXXoXXXX?oXXXXEXMXXXEoXXMXXMEX?X?XXXXXXXMXEXXXEBBXXBXMXXXEXXXXXXXEMXXXoEXXXBXEXXoXXXXXXXXXoXXXXXoBEXXBXXBXXXXXXXBXXXXXXXoXXXXXXoXXXXXoBXXXXXXXXXBXXBXXXXXXXXXXXXXMoXXXXXBXXEXXEXXEEoX
