?-----XME-o----EX--?-?-----M---E---M--B--o---X----B--------------------B-----oo-------M----XX---------------------o-----E-----B--X---Eo-MB---oo---oE----E-?----BXM-E-o---E-E--M------o--M------XB--X---T
o-E--?-o---M--B---B--------E--X?--B----MB-o--E-E-?-EX-----M--E------M--E----oM-BMM----------o-X--M--?-----M-E----B----E-oMo----B-BB--BXB---M---BX---M---B--oB-----o-M-X---M----B-----ME---?-o--B--------
E?-M?XE----------E-E-------o-X-M------o-?--B----oE--E-?--M---------?-BB---?--?---E-M--M--B-?B---------?----------oM----M-B--------B--X---o?-------E-X-M----E----E--------?-oB--------M---B-M-?--EB-M-BBM
XB------?X------B-?-------?-----BX----?--------B--Bo--o--X--o-E?---XB--B-X---X-Xo-----E?--M-M-?---E--o--B-----ME---M-----o--------XMB------?X-M-M----ME--X------M---B-----o-M?------o--B-----o--oX--B-?X
M---o?-M--E--M-M-------------o?-X-B-----M---E-B-oXBoX-----X--M-----?-----EoB--o----X--B---------------------BX--o-----MM--X-?B-o---X-------------o--BX---o---o--------EM-------MM--X-M?E--X--o---------B
-E?---M---X-M------o---B-------------E?o?-------X-?-oB--?-B--?-------oo-XE------oE-B--B----X-----M-?-----M-------------X---oMX-?-o-----?X-----XX-M---------X--o-M-----M---E---?oE---o-------X-B--XEo-oXM
B------M-o-o---------------?E-o-----X---E-X-Xo-B-----o---M--o-X-B-----E--?o-----M---EE----MB-X---?--B--oB--EM?-M--M?X-----------?E-B------M-?E-----?ME-BX-------B-oE--EBE---E-X-----M----o------M?BB-M-T
XB----M-?XBX----E-------?--M----E-ME---B---M---------X-E----------M-----?----X-?M-M--E-MBM-M------E?----------M--o-B--?-oB---XM?Eo--M--oB----o--o------EE---X-XM------MB-E-BBoo---------MoE--B---B--?--v
B?EBEM-?M-?----XX--E--E------B--B-----E-X-o--E-----X-E-o---oB-X--E---M-----M-?---o?Xo-E----X-----M---X--E-XM----E---------?--M-o--?B-Eo--BE-------B?--B--------E-BE--BE--X----BoM-E----E----o--o-?-X---B
B--X---X---?------B---E---B---B----------o-X--BEX---?------XMEE--X-B---?----o?-M----M-E--X------E-----?X-------E------EE-M---X---EB----o---BX-o---B--B--E--M--E?E--oX--------?E--X-B--oX--E----o---X---X
T-------XE---X-------MEM---M-X----MB-----------------B-XE?-X-B-??B--M-B--------M-E---?-E---M?-------M--B--M---X--BE-o-M---o----oM--?MB?----?XX--------?-o-----MM---B---o----X-----EX---BB-----E------X-E
BM-BM-X----BBB-----------E---XM-BB---------??o------o-E-----?MXB--X-E---------------E-oo--B--------E--M-Mo------oo----BMM-EB--------E?---BB----E-X--?-XM-o---M-?-o---?-E-B-----X----ME-----?o-------o--|
o-??-o------XE--B?-M-B--E--XMo---MB-----o---B------------MX-E---XB---M----------BX-o------------o---?-------E-------M--BBX----X-B-----XB--?----B-----B-----E----X----------------X----E----XE----?----?-
?--------XE-----------o---?E---oX--M-?-----Eo---X?-XoBME-----?-?o-oB---M---BX--?--BM-?----XX--??----MoE---E---?-o--B-?E-B------o----B----M-?o----XEB------X-B---M?-----?---?---?--M-BoXo---B?XEo-X----X?
m--------M---------?-E---?-E-o----------B-BB-o--?--X---?-?-Xoo-o?X--X--?E-BM-X--X-MM-E-?-------M-----------E----X---B-E-?B-X-oXoBM-----EM--E--E---X-B-M-B-BMo-X-X-B---B----------X-E---Bo-o-X-B--------?
XXXXBoXoXXBMXX?XXBBXXEXXXoXXXXXXXBXXXBXXXEoXXEXEXXXoXXBXo?XXMXXMXXXXXXXoEXXEXXXBEXXXoMXXXXMXXBXXXXXXXXXXXXMXXXX?XXXXXEE?XXXXMX??XXXXoXXXXXXXXXEXXXXXXXXXXXXXXXXXXXXXEoXXXXXXXXXoXXoBXEEXXXoXXXXXXXooMXXX
