-------------------?o-----M----?-------o?--o-----EEB-B----------X-E-X-X-?----------X?----EB--M----------X-B--X----M---M--------B----E-?-----B-?--o--E-XX---E--------E-------X------X--X---o----E--o--M--
--------M---o------X----BM------B-o-?-M-----M-----B-------XE--BB--------M--E-o-----------ME---?-XX--E---B----BE----E---E---X---o---o----?-?-oMEB-M----o-X---E-------MX-------M-------E----M-------------
----?--B-----B--E--o-?-X--o----M---M-MM---XE--?------X--E--E-MX-M--Bo---MM--o------E----?---MEo-X----B---M--X-X-o-------?-------E-------EX---------X-?BX---E------XB---EB-----E----B--Eo----------------
---EB----B--E-XE----B----E-X------?-o-------XoB---X--------?--EX-o--B-E-Eo---X-o------B------B----?-----------E-Xo-E---B-B--?----E-X----B-X----o?E----?-M-oX-----B-------o---o----X---------M-BMoE-X----
-B-----B--M--?-oX-----M---?B-M----Xo?-----------E---M--Bo--XBX-----X----BX---------o------o-E------M--?M-o----------o---o--o-----X--B-------------?--B--E--MX---?-----X--M---X-o--BE--o----o------E---?-
-M---------X----------E--B------B-------B-X----XM-B----------?---X------?-B-?--B-------M-----o-----M----?---B---o--oM--B-B-X--------------------X--?B-M------X---------X--E----?------?-XooB--E----E--B-
-X--E---B----------B--o-E----MMX---------?E-B-------oMBo----M--?----M--------E-o----B-X-EB--E---X--X--o----M---oo---------M----E---oMoo?---X--------MM----BEX-E-B------B------B--MoM-BE-M-E--B-----B--?-
-----------M--EXEM-------E-o-B--X---E-o------X----?----MX-E--o-Eo-B---EEB-M----M----o--BoE--E-------------Bo--------BoB--B--BE----?M-X-oo--E---Mo--o--X?E-----X--X----?ooM----?-oM---?-X------XBB------v
--?-------E---oo---M-?-----------B--E-EM??------B---?E--?-?-----X---?--o-?---M---X--E--?B-?-----------o-----o--E------X--MXEB-X-o-----?--?Mo---MX-----E--B-oMXB?-E-----B---o-E--?-X-----MME??X-?-Mo---Mf
--------o--M----?----X--EM------X--X-?-MXB-E--Bo-M----X----?X--o--o---X-o-oMX-----?---?----B-----M--?----Bo--MBM-----X---E-o--?--B---X-o----B-B----?-M-EB-BM-------M-B---BE---o--X--E---o-B--?---o---M-f
-----o--o-?---------X?----?X?----?-B---o--E---X-BM-?B--X-MB------M?-XE--B-----------M-MB---?M--M--Bo-----M-----------o-E---E-B-X-EM-o--o---XM?----MEo------X-----------?-o----M---M---E?--------BBo---Bf
---M-M?----X-----X-M-M-o-o--X----M----MM-----??B---E-X-XM--B-E--------M-M---?---BE-XM--oM-o--------o?EB--X-------o--X--------X-?-----MX?X---o-M?BE-?--oXMEE-MX--E-E?--M---B------XB---o-BE-----M---M-B-f
---B-o--E--?-----B-o-M-----E?---o-??EXM-o----B-EE----o----EEX---M--o-M--B?--XE-?-o--B----E?-Mo?---B-----?o-?---M-----oBo---?-X------E?B--?-----oE-X----------?-----------o--X----X-BEM-----------X-M-X-f
--o-E--X?-EX-?--Mo----------------o------o----oXM-M-?-XM--MMB---M?--MMB-E--M-----oo-X--B-M--B--------M--EM-o--?-M--B--M-------M-o---M----------E-------E-o----XX?BMB--o------E--M--X--M-----M--MXB----of
m--o-?---T-T-----E??-?E--T--T?-XB?-o---X?--?---TEB---T--?-----o--T----BT---B-ET--o-?E---o-E-----?---MT----E?MM-EB--T--E?-?--?--XT-?-o----T-------E--B-Eoo-?E-E?---E--B-----M--M?o-----X--??----TM--E?--X
XXB?X?MXX|X|MX?XXo?EXoBXX|XX|EXMXXX?XXXXXXXE?XX|XoXXM|BXEoXXXXXoX|BXBXX|XXXEXM|XXoXMXXXXXXXoMoXBXXXXX|XoMXXXoXXXXXX|MXX?XXXBXXXB|XXEXXXXX|BXXBXXBXXXXMXXX?MXEXXXXXXXX?XXXXXXoEBXXXXEXXXXXXXBXXX|XMXX?XEX
