-oXM--oM-?-B--E-XEME?---M-o--X--EB--ME--EX----EE--B?E-----X---o--Eo-X-XoB--X--E--B---o-EoMXB--?-oXB-o?oo--?---MBMo?-E-E--X-B-EEB-oM--XEMEo--oX-?---M--BEX-------B---Bo--E--E-E-oMB--EB-----X--BB?-M-----
-M-B---MXM--B-o-o--X-?--oo?X-MMoBM-----BM-X-----EX-----o-BE-----X--MXB--MB-o---ME-B-B?o-X-X?X---o-E-EEB-----B-XEMX-EB--o-XE-E----B-MoXE--MB-B?X--o-X-BX-XX-B-XBo-E-M-EE-o--E?B--o?-?-B---XM-?X--E-XoX-E-
-EE--EXX-E---?BM-?-B--B--XXBBE?------M-----------oB-X---XEo-E---B--XoE--B?XB--EX-------BE---B--Bo--?E?X-E-XBXB----?-MoB--?X--E--M-E--EX-B?-X----o-E-X--o-EB?o-BE-o-X------MX--E-oB-X-oXXBo-M-Eo-BBB---o-
-XM-XXoX--o----XXo-BB---B--EE-XX-o-oE--EE---X--o----o---B-X-------B-M-o--Bo--oo-o??E-EoE-X----oE?ME-EX--?--B-B---E--B?-?-X---?-MX?E---XBEE--XM-oMEX?-MooMX-BBXMB?o-B---Boo-X?--X-M--------X---o--X--B-M-
--o-------oX-o-oXB-X-E-B--BMX-----EEBBE---B------ooEMB-BXX-XBB?--BX-o-B-ooXE----B----EX-----M-XX-oE-X--B----B-E-oMo-X-o---BB--?-oo-E----oB?E---o-E-B?-EBoXEEX?o--E-oE-?X--E---o-B--oX-?EE?--M--?E--XE-B-
--BEoE----?---?-E-Eo-B-o-E?XM-o-E--BoX--o---XM--E--oB----B-o-B---?-ooEE---X-?EB?o-E--X--o-XB-BE-oX--X---ooXE--o--EE-EEo--M-E?ooMXE-BB----MXB-MXEEB-?-o--B---M-XME-X?XM----MoB--B-X--o-M-oo-o--M---M--X--
---B-o--E?E--o-B--M-----E-?--o---X--BX--XXE------XXB-B?---?-o--o?X--X-E--EX-MX-X-X--E-o---B--EMX---oXMo--M-o-EEE--------BoB--EM?-----E-o??-EX-X-Xoo-M-X-----EM-E-EBB-ooX-EEEE--oE-Bo--oEX-MMXX--B-BB----
---E-B-BEoMB--o?----X-E---??B-X-?EE-Bo------MoE--EB-oo--o----?oX-X---o-X-B---Bo---B--Mo-B----EMEB-Xoo-----oMEEEoB---E-E--X--B-X-B-M-?--E-----BB-B-MXE-oXoM--?B-X-----o-XX--?X-BXEE?oBo--XX-Moo-----o--Bv
--oMo----B--Mo-EXEE--E-----X-X?--EM-XEE-o-B----EB-oo-----?oMB-Mo-Xo------o-?XEE--B--?-E---B---X-ME-----XE-XBoXE-X-B----oE-E-?--oMo-BE-----ME-X-----XB-oo-E--------E-X--X-X---XBX---o-Eo?-----o-EEM--o--f
---EXX--------E?X-----?-B-BE-M---BB-o-X----Bo--EM-EX--E-BE---ooEXoMBoX-B--E-o-X-MXXoXE-X-X--XEooo----M-----oE-?EXB--o-o-o?-E-?-EXM--EXEo-E-MX-?--o--?BM--M---MEo---XoE--?-BBE-E?-M-Bo-EB-oo-----?-E--?-f
--oE-EBXE-X-EB-----BXo--XE-ME---oXEE-----X--M?-o-------B----E--X-oBE-B-E----E--B---?oBoB---EoM----E-----oEMME-XMo-----E?--E-?Bo-MBB----X-oM------M-o-EoB--MB--E----o?---o---E--B-??B--XBE-o--X---Xo---Mf
----?--X---BXo-oB-o---o------XE--X-BX----o?B---X-MEoB-B--BBBMXX-o--B--?-XX-EXX---E---?-BE-----B--E?-E----?Eoo--B-----E?-B-o--Booo--XB--oMX----?-M--ooBo--E-B-X-oo-XB--XX-o--?-o-o---oE--E-o-?oB--oX-oBXf
--B-o-E---------E--X--Mo-M---B-BXoE-oBB?BB-E-E----XBE-M----o--?-EE-oX--B-EX---BBX-?-?M-----o-?o-Bo--o-?E-oB---XBBo?o-B--oXXE-X--o--o---B--o--o--?oo----?--EEEM?-EBXMoXM---EXBEX----E-EoXo-o-E-X--B-BX-of
-o-o-oEXo--BBX--B---B?M-B------oXEo---XM--oMBBBo-o--------B?--?-----X-o-XB--E---o-MEX-MoB-E-E-B-----?EMBX---E?--?XE---Eo------M-o-?M-XX--ME-E-X-?-?XMo--MXEBo-XX-o-E-o--EXMEo----M?oB-EXB--MM-BME---E--f
m?----M---XM?E-BB-EEB-XEo---BX---E--oBB---------Mo-B-M----o-B-----EB-E-X-E-X-o-B-o?-EX-E-MMXo-?MM-?o-oX-EooX--B-EXo?----oBoBMX-XX----E-X-Moo-M-X-X-EEBXM------X--?-B--oX--M-MXBX-X-M-E-XE-E?X--?oMXM--oX
X-?o---o---BoBEo-EB----oBoX----MX-----o-X---MEM-XMX-X?-??-E---BEBX------BoB-X-E-o------E--E----Xo?o?oEoXM---ooMoBX-BX---X-----M?MB------------o----?X---M-B--??Xo-o?-?XMoB-X-E-XM-E--o--o-E-oXB--BM-o--X
