-o-XXX-Eo-XBBXoEBX--Xo--EX-XM--XXXEXXB--oX-XBEXEXX-BXEBBEXE-BX--o--?oM-oE-B-o-EE-EEEXM?BE-----M-o-ooX-XB?XB---X-o?-X-E?EoXEo-B-oB?XEE---?EE--XXX--o-BE--EE--EX-X?X-EEEXBE-EBEo?EX--XEE-------XE----E--X-
--B-MEBXXB--B--o-XoE-oB-oXoEX-EXEX-E-B?X--EX-XXX--BoB-BX-XEEXEXEo---E?X--B-XBoE?XEBBoX-B-EB-X-Xooo--XBEX-oE-E----EX-??oEXBBX---o---EXXX-X-?--XXXBXX---E-X-oEXXBMX---?o-XEoB-EB-XMEXBBE-X-?X--X-BE---o-E-
-oXXX-E-E?EMXXX---BE-M-EoEBM-XBoXBEXXXE--oE-BE------EXXXXEXX?Bo-MEXB-EXEB-XEo-X-XEX-EBX-EMX--EEEEEEo---EBoE-BEMEX-?oX?--ooXXEX--oX--EB-E-MXBE-E-XX--Eo?XoEEEX---oXB?-oo?E-o-X-MB-EEXMBXEEE-Xo--EXBX--EE-
-X-?-M--X--X-X-X?X--E--EoEEX-Xoo-??-EE--BEM-MMX-X-o-EX-EEE??-EXBEEE-E-Eo-EX?-o-EE-oB-?XoXMB?--o---X-oooEE--X-XX-oEX---E-E-BoMX-oBXX-X-EXXBoEEEBBEXEBXB-X-XXBX--oo-X--Xo-oB-EE-----XM-EE-EX-M?BXoXM?---X-
-XBo-XM---oo?--EXEM----?-BM-XXX-MEM-EEM-EXoX-BMooEMB--X--XXX-E-?-BXoXM-XE--EEXo--EBEBoXBXEM--BEoBXX---?E--X-ooX--XM--EXE-XE-EXX?-XBX-EXXXE-EXXXXEM--X-oEBXXBXMEEX-Bo-E-EB-X-XXXEXEEE-Eo-E-BE-M?BX--BEXX-
---oXEXMooXXM-oB?-E-EB-?EMEX-EBBXXE--B-?B-XBXX-oMoXB--EEX?X-oMoXMX-XX--X---EX-EE-oMXB?XMBEXoX------BEB-XooX-X--XoEBB-E-?---EX-E-EEXXX-XXXXX--BX--E?XX---XEEXXE-EE---X-E--oE-X-X--EEMEX-MXX-oEoB-X-EE-oE-
-ooEEXoE-X--EE?--oXBEXMEXX-XoXXBE-MXE--X---XEXXMB---?EE-XX?-o---X-EoXoM-?EB-Eo--?o-o?BB?BBBE-EEoE?X?XMEo-X--BE-X-MBXE-XE-?EEXMEB-o-EBEoE-EM?E--X-oMX?B-?XEEX-XE?XoBE-oXMXBEBXEM---MBXEEMXXXEE--oo----EE-
-E-B--EEX----MEo--X-BoEBX-oXE-EXBo---XMoE-ooXX-XXBX?EM----Xo?XBXEE--oXoEX---E-EXXEXXo-B--MEo-EBXXBX--EBEME?BEXEXX-XB-E-X-----BEMMX--E-ooXBoE?XoMX-EBoBX-M-EEB-X?XB----XMX-BEB-?X-BXXE-EE-E--X-E-BM?B--ov
---EXE-oBB?EXo-EEB-XB--XEX?BB-oXB--Xo--E-M---B?Moo--o--EEXE?-XX-X--ooBM-?-ME-?-X-MEEXB-ooE--E?-XXX-o-M-X--E-BE-EEX--BXBoE---EMEXXBEE-X--oXEX-BoBBEEEEEE-EXEoEBXEEMXXEXoE-?MEEXMEXMEX--E-EXEEEXoo?MoX-o-f
-X-o-XE----Eo-B-oXE-oXXB-oMEEE--oX-Xo?-oXX--XooXXE--X---?X---E-EEEoEoBM---o-oME-EE-M--EB?-E-EEXooMMXBXE-XEE--oE-o-XXE---MB-XX-?--XE-XXX-BXX-EEE-X?EEBXBE-XEXX-EXEXM?-?EEoXXoEE--E-X-o-Eo?XM-o-Eo-Eo-?M-f
-EEEE-XXEX-E-o-ooXXBMEEXoEEMXBE-MXXXX-oEM-EXooXEMEX-XE--X?BEMXEEoBE-BBBBE-E-BXXM--EEo--M---EE-X-Eo?XEXoBEX------o--X-XBo-XMBEEM-oo--B--BXE--M-E?MMEo-XXX-X-XE-BE-XE-EXBoXB-?XMX-M-XX-BE---oEE-EE-Boo-X-f
-E-XEo--o?E?E-XBME-E?EEE-EXXo-X--EooEBEMXMX--EoXE-XBo-oXo-XBE-E-E?X?BE-Eoo?-XBE-MB--Mo-E-XoB--EXX-MBB-EXBoXE-BM-XMooB-?-XX-MXXXXM-XBB-XXEEoX-XEoEXXEEEEE--Moo-B-?-BMX-?BE---XEXE-E-MXXE-E-X?XooE-X----Xf
---E-----XMoMX?XXX-X-EoX---XEE-E-XBX--BXB-X--?ooEXEEo-XXoEEo----oB--X-X--oXBo--Xo-o-?X-?E?M-EB--XE-M--XBBEXBBXE-BMXXB-BB-EoXEB--XMo--EE-XE--XoB-Eo-EoE-XX-X-X-X-o-XXEM--Bo-X-EM-X--E--EE-BX-EXME??EEE?of
-o-XXX-?XE?-MEEo-o-E?--Eo?oE--Mo-oX--XEXBE-oEX-E-XEXBEoEE?--BEX-BEX-EXBX-BEE----EXXBX-X-XoXE??----B-M-XoX--XEME-EE?EBX--E-X--X-oXX-Mo-X?Eo-Xo-B---E-oEXEX--B-oEE-BM?-MMXBEX-BBXBXE----BE?E-Xo-oX-oMX---f
m-E-o----BEXEoX-XE---EBME--XXB?M-EooXXEXoEX--X-E--Xo-o-Xo-EXXoEMoMoE--XXXBX-oE-B--XoX-EEEBB-E?BB-BE--E-XEXXXB-o?Mo-o-E-XEE-oEE?-X-XEX-E-EB--?oXXE--E--E---X---XE?XXEEX-oX?oE-B?X-E-XEoB--EEXBMEXBE--?X-X
XXE-X-oEEE----E-XEEEXEEEXEBBM-EoB--o-M--BXEEX-EE-XX-oXX?--X-X-E--EB--B-E-BX?oEoEBX-XXEo---EBoXBBBX-BXEoBEE--E-B-MEEXXXEEEo-EXEMX-MEXE-XEEEEoXo-EXX-XX-X-o-EEEBE?oXX?XEEEE-X--XXBB-o-o-o-EX-E-oXMoEo-X-EX
