-E-----XX---X-------o----------o-o-XX--------E----o----------E-X-------------------o---E-----E-----o-oX-------E-----X-------E-o----o-------X--------o----X-E-o-X----------------E-----o------E----X-----
-E----E----------------------------X------------X----X-------------------o-------o--E--------------------------E---oo------------------------------Eo-----------X-----------X----o-----------E----------
-------o---X--Eo------------X---------------XE-E-o---------E---o----------------o-----------oX-----E------X--E-E---------------E-o------------------------Eo--X----X----------E--------E-oX-------------
-----X-----XE-o-----E--X-oX------------E------------o----------o--E------------E-E-----E----o-----------------X--oE-o-------E--o------XE-----o---X--E------------oEX-----E--------E-E------E-------o--E-
-----------X-----o-------------E-----X-o---Xo-----E-------E--E---------X-------------------E--X-E--X--o-o--o----X-----------------------------o----------o---------------------o--E---------X---X--E----
------------------------o---------------o----------o-X-X--------------o---X-----o----X---EE------------EoE--oX--o---------E----X---------------o-----------X------Eo-oX------XX------Xo----Eo-----------
---X-----X---------X-------------o-oX-----E--oX-------o-----X--------------E----X---o--------------X--------E---------o-----E--X----E---E--X------E--------X-----------------o-------X-o-------------X--
----oX--oo---o------X--------------E---------------------E-----------o--X----------o-------------E------------EE-------X------XX-X----EX-X---Xo-Xo-------X-X--o----o----o--------X--------------E--X---v
--X-o?-??---M---M--Bo--------MX----X----o-------X-E-E--------X--M-M-??-B-BX---M---BB------?-E-B--o--M-------Xo-?o-X---B---B-------B----E-B-------o?--B---------E-M--B-?--?------M----------BX-E----M?B?f
--------oX--BB--M-MX-----XB----M-?----------EM--EoX-----oo-----BXoX---MM-------oX---------o------o--B---X---BXXE---o-BM------o-----------E-B--X---?---M--?-E-XB----E--------BoX?E--XB---ME?-M-----M--?-f
-?E-?o--B----MMB----MM--B----?-E--oB---X-----o--M--------M--o?B---?B-X-B-E-----?-------M--?--------X-XX---o-M---X------?---?---E--BE--EM-------X-B-X-?M------X------B-ME----------?-?---?--MBo--M--?M-Bf
-o--X----X--------?---X-------X-?-E--E-M------Xo---X-M----E---MX-?-o-?----?----E-?-?M--------MM--?--oE-----------B-----?M------------X-X-E-B-----M-o--M-X-----M-----B-----B----oX-----B--?--oXo-o-BBB--f
-M-BX------M-------o--B-X-?------------B---X----?-M--EEM-E------M----B-oM--o---------?---o---M----E-M-----?B--X-o-M--M?---B-------B-----o-----B-M------X?BX-o---o--B----MM------------X---M----?M-----Ef
--???------oB----M----M---E--?-E?----X--B-M-----o-X----?--BB-M----X-?E-----?-E----?---B-EM------B-B---B-EM---M----o--?-?EE---------B-?-E--------E--E--?E-E--B?-XM--?-EM--?-o----o-----X----B-E----?--MXf
m---------Bo-B--o--BE-X-MBM-o-----E---o---M--------------B-E---?--B-M------Eo-------??--E--o---M--X----ME----E??-E--------oX?E-E-------E---E-------X?---M--Eo?------?--BX------M-EB----Mo--o----o-X-XX-X
XoXXMXoXXXM?XXXXXBXXoXXXXXEXEXEBoEXXXXBXXXXXXXMX?oXXXXEXEXoXXXBXXXEXXXXXXXXXoMXXXX?XoMEXXXXXXXXBXXXXMXXXXXXBXXXXEXXXBX?XXXX?XXXXXXMEXM?XXXXXXXXXXXMXoBMXEXB?MoXXXXXXXXXMXXXXXoXBXXXXXX?XXXXX?oXEXX?XXXXX
