-------X-E--X------X-M------B-----?-------XMo--------oM----X-------E-X-----X------X-------o-----?---BM--------B---o--o?---oX-----M--o----B--o---M---------B?E--o-M------E--E--X----o---------------X--?-
--E---M-B--M-o-Xoo-X-??---------B--?M--X--E--MX-------E-------o-----X--X-----?B-o-o----E--E-----------o--o?---Xo---oBo?--o--XE-----X----B---X?E--E?---oB-M----XXBXM-o--E------?-X-----EE-EE-------o-----
--?--E---oB-M----M-----M-XX----E--E---?-B--BMM---X-X?---X--?---B--M---o----B---M---E-M-----B-----EoM-M----o--XE--X--E---?o------EB?---B-B--o-----X-----o----?o--?X?-o--M-Mo---M--XXX-X-----?--B-M-B-X-E-
-o--XB--o-M---X?----E---------------Bo-?-EM---Bo--B---?-o??ME-B------X-B--B-----------X--o---o--o----?o--X?E------X------Mo------X----?X---B----EB--------X-------o-??B-----BoBM?B------B-?E--E---------
----M?---XE--?--?XBBB-?--------o-?-o---??-M--o------o?X--o----?-B----E-B--?------M-?----M--M---o-E?-------M-X--ME--XB-----M---M?------X--E------?---MBX?--BXE--E--E--------Bo------Xo--?-M--X----B--X-M-
--X--M--E------B-?--------?------?-----X------B-EEo-oE-BM-Eo--X-B----?-----------?--?EX------X---?---?---BX-oM-----Mo?-M--oB----M--B---M-----------X---X--X---?oB-----o-B-X--?-B-Eo-E-------B------M-o--
------oB?-B-B-------X--MX------------X----------XE------BM-------o-B----o------XXMX?---X------B---M---E------?--X----------?--?-E--------M-------E---M--?o-------BE--B--BE-------B---X-?---X-?---M------
-M-----------Mo-BM?-------X---------B-?M-------BE------X--M-o---?--X----EB----?B--M--------?--oo?-----EB--E---?o-o-----X--X---------MEB---X-MBM--M------o----o-------E?--M--E-??--XX-?E--X-X-M----E?-E-v
-X--?-----------------------oB-oX-BX-----EEo-E-E------E--E------EE?-X-E-o-X-?----XB--M--o---E--X-B------X-BMMo----?---?-X-BX-X--XB--X------X-o--M-o-BX--B-?---E-oo--XM----MB--o--------M---o--o-X-M-M?Xf
--X---------M-M-B---------M-----B----E--M-?E---M-----ME--?-M-o--X--M-o-o?-----o----------?---o-E---E---E----B---E----?---------------XXo?-B-o-Eo---X?------XXMXo--MBX------------?---?-----M--B--MoME--f
----??--X-E-M--?o--?--M-MBEE-B--E---o-?----o---o---?-X--E---X-M----B--B---o--MEM----E-o----o---B---M------oB--Bo-E----------------oX----B---EX----BEE---M-----E---X-----M--E---------------??---B?----Ef
-------o-o---B-B-M--E-----B-M-??M----B-X--M-?E---o-------B-B-M----XE--------o-M--B-Mo---?---BB----------oM--EM---BE--B-----BXME---------MXo-B--------M-----Xo-o-B-o---B---------B----o--M-X-----o--MM-Xf
--B-------?-----E---X-----?-M-B---------BEo-E---o-M---M--B---------?o---X-o-BE-MX--Eo---X--?------M--M---B--o---o--?oE------?M-M--BB-----X--E-o-----?--X-M-EEXXM--M--X-o----?E----o-o-o--M-o-B-----M-M-f
-M-E--o--X-B--M---------M-X---M---Eo---B-----oX--oo--X-M-B----M-----?M---EE--MX---?-oMB------?E--?o---o------------M-X----o---BE??------B-X--B---M-------oM--E---B---MM----B-E--B-o-EBE-------X--B----?f
mo----M?---o--X-B----------E---?------------MXE------?----M-B-?-?-BoME---E-X-o----X----?B--------XM----?---?-?-?---X-------oM-o----?-E----XM----X---o---oEB-E-Eo--X?B-E-o----B-??--X-----M-o------X----X
XMBXXXBoXXXXXEEXXoXMXEEXXXXXXXXXXXXXXX?XXoXoMXoXXXoBXXXoXXXXXMMXEXXXMXXXXXMXXXXXXXXXM?XXXXXXXXXXXXXXXBXXXXXXXXXXXMXXXXXXXXXEXXXMXXXXEXXXXMBooXXXXoXEXXXEBMXMEX?XXXXXX?XXMXXMXXXXXX?XXXXXXXXXXXoXEXEMXBXX
