-XB-oE--?--?-X--E-B--BB-X---E?----?--------?----oME-o------M---?--X-----oo---X----X--M-?-BX--o-BM--X---oX--B---E?---B?---MM-o-?-o--B--o-B-----XXM-M----M--o?--X----------MBME---EB??-----o----------X-?-
---oXE---X---?----Mo-MX-----X-------o---BX---X-o------B?--EBo--?-----B?---B--B-E-EoMB-E---?E-M---o-?----------X-----X------oM-----M----o?XBX-X--X--EE-o-XM-------E-BE------------E---oB---o------?-?----
---X-B-----o----------B--EBE-----X?-B---------X-o-B------X?-B------M--o-X-E---ooB-------E-o-----B------XX---X----E--X?-------M---?-----------B---o---M--o---o---o-X-X------o-------oX-?---------X-?X-?X-
----B-MX---X-X-X-?X--X------XXo-XX-MB-?--XXE--oE-o-----o-------?----X-M-MM-E-B-------MBX?X----MM----?M-X--M-B--X-------E-X?-MBXX?-?MB--M--X-B-?-M------M-MM--X-X-MEE---X---E---X-X--BBo---ME----X?----o-
----MMX-o---?-X------B--Bo-X?---X----o?B------E--o-------o--BX--X--B-------?B-B--B---MX-------BMX---XE----BB---M?-?---E-o-XE-----oX--Mo---E------?----EEo-o----M---?B---XoX----o---?-E-E--BB--XoE-MEXXB-
-------BX-BE-E-B-?E?M---B--X----?BX-X--?------M--o-X-MXEX---E--E---M----?--M-?B----EB-o-M-M--B?-MB-----XE-M------E----E-X--X-XBX-----B-o-?-?------MXMX-X?-o-----oX----?-XXE---E----?-??X----Eo-X-MM-E---
----X---B----X-X--E--------?X-------o---M--o---o-M-BM----E---E-X-Xo-E-X-o?----BM-M-oB--o-E-----X-----E?--?X--XM--X--X------?-----BX?--------?-----X-XXM--M-X---------oE----E----?M--M-BB----E--B--------
--E-----E--E?BB-------B--oXEEoEEo-------X-E--B-o----E-X---X------o-----?M-X--X-B-X?E----M-X-X-MX--X-XE------o---------XX-?--?EX?-B-------M-XX---?XMX-X-------X--M-X-M-EX-M----M----o--E-?Mo--?-----?EXov
-o-------BoM-X------?--?------MX---B-o--------------EM-XXB---------?--------X--XoE----------E--M-----X---B?--E--EE-o-E---M-E--X-B--BoM-B---o-X-XB-?-?-----X-E?---E-X---X-----X-M-E----XXo---?-----?o-XBf
-----?--o--?--M--E------Mo-X?------?X-E-E-----M--o----oMX-X-B--o------?-X---B--o-X-XX-?-----X--E---?X----o----M---MB------EM--BX--X-X--?XoX?o-XX-?----oMEMXo?-----?-oXE--M---E--MXX?--E-M-E--BM-X----oXf
---------B?---?--E-o-?M??--B-o---XX---EX--M?B?----?B-o---X-X-----BX---X-----o---XM?--?--M--Eo---?-MM-----B-B-?-------E-BM?--Mo----------o-M--??---Xo---X--M-o---B--Xo--?BMBMM----E-oX-M-------o----?--?f
---MB-----XBB-o-XM---BX----E----M----B--o--?-X--X-E-?---B-M--oB--------o-?-----Xo--X---X---o---o-E-XoXB--BX?-----------E-EEo--X-E--ME-MM?oB--BMM--Bo-E------X-----X---XB--------X-XX------M--E--?X-M-X-f
-----EX--E-------X-X-o---o-B-----XX?---M-----o-EM-----M--?XB--B--X------o---X-M----X-EXo----M?M---B------X------M----o--X----EE--oX---EEE--oBE-B---?--XM--E-E---?--XE---M---EE---E-MXo-EXM-?-----X---X-f
-----BB--E?-MXB--X------E-o-----------M-o-Xo-E?----BMEM--MBX?X--X-X---E-oB--X-X?---?E--B?B------B-X-X---XMB------E-?XXoE-??-E?----X-------?oE--o---E-----MM----Xo-M---?X---X-o--BMBE---XoME?--XX-oX----f
mX-?-B-----BM-----X------?--M---o----E-?X-M----B----oXX----?---?-----o?M----------?---B---?X?-X----EE-X-BXE---X-X--o--o-M--X-M--MX-?--Bo------XE-----E-?-------X--BM---EX-Xo--X---E---E---X--------o-X-X
X-?--EM----E------ME---X--X--X--?---?----X---o-------o-B?---o--EM----E-----X---?o---o-XE----XX?--EX-B----E?--MM?EXEM?------B--------BEM-X---X----B-o---------X----EBX-BX-XB----M---EB----o-------X-EX--X
