--o--oE--X--EoEMEXBXMMXEB-?-EEB?E-EE-MEoBXB-E-EMB?--MXo-E-BooX-oEoEX?BEEBXXoXB?EooMB-EBB-B-Xo-E?oX-o-EEBXBX-E-o-E--BEE--E---EEMX-?X-E-EoE--Eo-B-EXo-oE-X-EE?-X--XEMEo-EEEX--XXB-EXEB-XB--?-MEB---Eo-?X--
-XMo-XX-?E-XXE?oX-EB-BBXBXo---B-o?EX-EXBBX-oXXEX-XE--oE-ME---o--EB?XEE--EX-EEoEoEE-oX-o--XBME--E--E-BEB-B-EEXXoM-?EEoBoBoXXE-M-E-M-X-XBXEX-B?BE?X-X-EE-BE-MMEB-MXEEMX-XX-BBXXXXE---BM--X-oBoXX---BX---o-
-------E-?-MXEEXBME-?X-X?--MMo-XEoX?oE?-E?ooEEEEoBXEEX-BoE-XEEE-BEEEEEEXEBX-o-oX-B---EEEEo-MB-M-XB?BB?--X-?EEEB-X-X-XBE-?-M-Xo?-X-X-E--EXMXME---EoE-ME---E-X-EEEX-oEEXEMBEE-?EXEX-E-??BBEo--oBE-EB?EEEM-
-XXEEBE?BE-oXXo---XBEMEEX-X-?MBE-BE-X----XEE-XXEEXXB?EBEEo-EXB-BEoXX-XXBBM-XE-XE----BE-XXEX-XBX-XXXBEE--XX?E?-B-EoEEEE?-oEX-E-EoXXEMXEBBXBXM--X-M-EEE-?EEoMX---oXX-M-X--XXBXEEEX---EB-----XEXX--?o-oXXE-
-BoE-EEEEEE?XE-EEXX-?--EE-EXEMoE---oEXXMXEEE-EBXE---X--?-XBEEX?-BX---E-EX-?X---X-XBE---B---oEE-XX--Xo-Bo-EEE-oEMo--?--XX?Eo?XX-B-?M-EEEEE--E---Eo-?X-o-X--XoB-BEoM?B-XB-X-XB?XMoBo?MMEBo--XEo-B?-oEo-EE-
--BEB----EE?-BooX-MB-M-B-E-B?MXXB---E-XE-BEEBBXEX-X--EEoX-BE-Xo--EX-B--BMoEMBo-?M-BXEXEBoXEEX?X----?XE-MM-XXXXX-EBXXMX---E--XE-M-X-BBB-M-BEEEBX-XEE-EMXEo-XEXE?EB-XEX---EMEo-oEXEX-MXo-XXE?XEXo?EXXoXoE-
--XEX?-oBoBoB-oBEEMXMoE-XXXXX-X-EE-X--o-XoE-BoXEX-EBBX-MB----EEXXo-EoXBXXMEBXEEEX-X--o-?-E-XXXXXBEEE-XE-XX-EB-EXo-MEX-o--X-XXX-E-E-oB-?-BX---XE-X-XoEMMB-?X-o?oXX-?XEME-BXo-BEoB-XXEX-X-BX?E--E-oXX-Xoo-
-?EEMXE?-?--EEoX-MBX-B-MoXX-M-EE-EXB-M--X-EEXE-EE---E--B-X-BEEoEXE-XX?o-EMBB-EXXE-XEB?XX-X---BBXBBXXMMoEBEX--X-EEX-X-Eo-XXBXXX?-o-Eo--oEBXXo-XBBX-BX-EBMB-EXXo-EEEEMB-BE--?--Bo--o-M--M---XBXE-o-BooXM-v
--EoEEXoX-B?----B-MEEE--MME-X-M-EoEEE-EBX--EEo-?BoX-XX-XE-EoEBXX--MXoXoE-oMoMEoEX?--oXM??-BEBX--XEME-oXE-EE?EBoEX-Xo--oBX---EXEE?XEEBE-B--XE-E--EXX-XBE?EEEEBoEXE-o?XEEBEEEEBE?-XE-?B--MX-XEB-X-X-BE-BXf
-XX--E-XMXMEBEoXX-X--EE-oBX-Bo--o-oXXE-BoXEX-E-XM-X-X-E-X?E---E---BoEooBEEEX--?XXXXE-EMXXEXEBoXX-Eo-B-E-BoEX--E-XE?Xo---EEEEX-B-EEX-X---?EE--E-XXXX-X?--ooXXX-XMo-?XXMEMBo-BXo--EXXXoMXo-?B-X-o--E-EE--f
-M-XB?oo-BoEX-XXEX-XMXEEM------XoXX-X---EoME?-E--EE-E-E?XXo-E?o--M-Eo-B-?--M--M-E-o?Xo?-E---o-EXXBX?-X-B-E--oE-EBEBoEoEE-E-MBX--?XBXX-X-?-E--XXX--X-?X--X-oXBX-XE-?oEB-XXEEEBEEEXEE?B----E-X?E-EBMBXo-Ef
--X--XMoB-EXM?BEoBXEX--EBE--BXMEE-oE-EXo-oXXE--??--E-E-o--oE--EoBMX-X??X-ooEEXoEX?B-?BoEXB-o-o-oXX-B-E-oEEB?-o-EoEE?-XE-oBX-BE?---MB-EoX-EX-oX-BX?EXEX--B-oE-Xoo-XXE-E----Xo----X--XE--E-EEMo?-Eo--MXXXf
-Xo-oBEX?BB--X-E-EEB---X-XX---Xo?E-----ooMBEE--E?MBEXEM--BEEXX-E-Eo--XXX-oBB?-MX-Xo-X--XM-B-B-oXEX?-XM--X--EXXMM---EXE-XBXB-B-XX-E-EM?Mo-M-XE-o-XX-?-Eo------XEoB?MBoEBE-BE--EMoX-EXB--EBE-?oBo?oME--BBf
-oM--X--EE-X-XEEXo-o-B--X-XBX---BEBB-E--XM-EXX-oEE-----E-XBE-E--XE-MB?oB----XEo---oMX-EE-M--EoMBM-B-BXEoB?EXEEX--?-Eo-EBX----X-EBo-XXE-XM-E-XoBEoX-oX----oEE----XEB-MXEE-E?XE?X-ME-X-E--X--?-EXoEEX-E--f
mMXXEXM--EoEoEo-E-EBXXB--E-MEBBBEEEMXo-EBEXBXoE-BoBoBoEX----E--BEE-BE--oXEo-X-E-E-EX-X?-?BX-M?BooE?-----X---E?-EX--X-?B---XB--MEE--Eo-?XMoX--?---X--E-X-?BMXX--XM---XB-BEBoXE-E--X-M-XBMoXE?EEEoo-XBXo-X
X?B---?-EM---BE-XEM?XB--B---M---?oX--EXEE-E-EXEM--XEoXoBX-?XEB-?B-BEE-MM--XE?XEE-XM?-?BBoXEXoXXE??XEXEMoEB-MM-oB-EE-M-o-B--BXXEXEX---XX--XM-?EEEEM-EoX--XE-?---E--X--EEE----?-XXB-BEE--XX-XMo-BX-o--oX-X
