----o--------o------oXE----oEMX-X--o-M-X----oo?----XBM-E-----------EXE--X-------X----MM----EXE-------?-o----E----o--B------o-----?Bo--o---?-B--oBX-Mo---?EX?---BMX--B----B-X--o----X--MXE---B--?----E---
-B-?Bo--?BX---X----oE--X----o-M---?-BM--oE?B---oX---X------B?-----E----o-o-X--?-o-------XX--MB--------XB?-???---------E---X--M--EX--E---M-M----X-XBoo--X-----X--EX-------E--MB-------E---XEXo-----------
--o-----M??-----X-?---X-Eo--o--M-E---X---M-B--o--Eo---?ME---B--EB---BBM-M----------o--------E---BX-X-EEM---?E--X--B---oE-------XM---oM--o----M-X-X--M--MX-------------XM-E--X----M---X------o--?XE----?-
--MXBB?B-------M--Eo--M--XEX--B?B-----XX----?--E?-X-----X------X-o---XEM----X---X--BB--E-o---XX-X?---M-o---o--?-X?--------B-------E------X----------MXB-------EBo---XMoB-E-----M--EE-o---oB---X-XB------
------------X-XoE--M---X----------X-------o-BE-?XEE--------------M--EM-X-X?XB-X?-----XX----M--X---?--X-E--X-------o---B--E-----B---------M---X-B---M-----B---?----B--o-X--BM?EE-X-o----oB?---B-?----M-E-
--EMX--X?-EX--?EX----B-o--------?o--M--o--?---M--ooE-E-X--M?B?o--oMM----X--o--XM--------?E--B-X----B-o-?-----XXo-oX----M-----B--o------B------o-BX-----X---E--BX----E-Mo---ME-BE--o----B-XX-E-E--E----?-
--XM-M-------X----X---?--Bo---B--B------?-----?XXB------??E---o---M-?-X--o-----X?o-E--?--oE--XB-------X-----o-?-X----o--o--o---B-----XX-o----o-?---XEE------B---MBoX-X-XE-M-?-------X-EE-X?-?o-oE-XE-o?-
--Xo---XM------o--oB----EB----X-BXoXB----M-XoX---B-o-MXB-X--X--M-o--E----E--B---MEoo-o-?-oB-M---M---------------oo-E-----XE----X?E?----EoX-E---------Mo-B----------X----X-M----EB----B--B-E--X-E-X-BX--v
-B-M-----X--?--------B----Mo-X-----X-X--MMX--X-B--?-------M---E--M-o------MX--M-E------M--E-X?-?------X----E----M-oX-?---XXB-XX--M----X-?------M-X------B---?--X--o--M--M-----X-E-B--BE---M---X?-----oXf
--X----o----Xo-----XXXX-----B?o--X-----M---?-B---E-XM----M-------?---o--?----E--o-----E-o---M--?---X---Mo-----BX---X-o----?-o-------o-E----?X-X----X?-?o--M---EB---X-o-X--?-MX--o-M-oXo-o-X--?--?M--o--f
--o--XEB--?EX--BEX--?X---X---o------M----Eo-M--BX-B-Bo-??B---M--o?X--EE--?-XM--?----E--M-----XX--MEX--BB-X-X--B--E-----E?-MM--------E?o--?-XMoEX?M----MX---X---o---X-M---X----XX--M---?---XE-E--?B-----f
------?-X-E---o-o-----o-?X--XEXM-B?-----EM-----E---o--EM-M---------XB--MB----XX--X--B-MB---EE-?----EMX----------B?-Mo-----Xo----Xo--B---E-M-X-oMM--M--X-?---------E---X-EX-EB-X----?--EM-----X---X-?---f
--B----X----X-oXMX--oE-X-oX-------B---B-BX----------EXB-B-------E-E-X-XEBE--------oB----EE-----o-----?---Xo-----X-o-E----oE---o-XM---E-E?-------XMMM-M----X-BM--X------------oo-----o-M--B----BE-------f
--X--X---X----E?--X-----E-oXoX---X?---E?--XX?----X-?o-M-oo-E------X--X----B---M-XX--M--X-o--X--oX?B-o-X?--M-Xo--o----?X-E--M-X-EX------M------o---B---?o--o---M---o---MoEX--EE----E-ME--M-M-B-B--------f
m--o-?XB-X--X----E-E-B-B-ME--M--MoE-X--?---MEo--EXXX-X------EXXX----M--?E---M--E-X----X-?--?------B-E-E----X----E-X---?----M----------EE--X-------?-M---------M-X--X-----------o-E?-XXEooBMX--MEB---B--X
X---------B-----X------X-------EX-X-B--M-X-?-E---X?---M?X---?X----Xo---B-BM-B----?-?E-XM---?--X----X--oMXXo?o-EX---o-oMXE-----B-X-X--X---o---?-B-E---X----B-o-EE-?---B-?------?E-E---M---B--X-XE--?----X
