----EXMEBE---M---XE---EX-------oM----------M--X-----?-B-o-M-E--o-o-?--o-?---XXX-E----------?-------B---X-X-M-?---?-------X-?-----X-----------X----oMo---------o--X-?-X-Xo--X-E--X?M-o--B--E-B---?MEoX-E-
----?--X------M----o---E?-E--B-X-------B--M--X---E-X-----B---X-X-E-------BX-----MBM--X-E-o-M-----BB-----?-----XXB-o--XX-E---oX---E-----------o---X--?MXX--MX--B---X-X----??EM-o--------o--X-----------?-
---Eo-XME-----------?o--Mo---E------X--o---B----o-?--E-B-?--X--X------Xo---B---E-------X---M-EX--BX?E--B-oBE-o---M-------?E--X--------BB----?-oo-----X---?E-----------XB---------B---E----o-EXE-M-------
---B-X?BXE-?---o-?------M--B----oE-X--E----X--?--o------???-BX--M?--oX--X-BB--M----?-X-X----?-------EBXoE--B--B--------BX-----o-o-X-?M----oMEE-X-o?-------E?----Eo---?---X--X---B--BEX--o---X-X--M------
-----X----ooB-?o-----o?MB-X-?XBoB-----X-B---E-o--E--M--M---X--X?-BE----B---BE?M----E-B--XX--Bo-E-------X-M--oM--oo--Mo----ooM?Xo-E-Mo--------B--XB--E----B---B------o-BE--ME-----X-?-E------X--?o-??--o-
-X--E-B--X-E-E-------E-B-----M-----BX--M-----------?-?-E-?X-M-X-----X--B--B--?o--E---X---?M--EM--EE-X?----X----M?-----BB----M---X--?B-------X--E------XB-X-M---------X--X-X--MX---Xo-----B--M----BE-?---
-----E--------?EoEoXE--XX---E-Bo--o---M----Eo-???M-----oM--?X-MB-B--?-----E-----E-X-Eo--?-MX-X--M--------X-----o---X---M-----BE---X---M-X-X-X-?-----?-?------EX-X---X-M---X-------X--X?XEX-----X--------
-X-o--X?---M-EM--X-X---MB------X--oo-M--EBM----------B--oMB--X-------o-E-MB-------X----E-X-----?----??---M----??-X-E---------o?o-o-M?-------B-------B-E-------oo--EM--?--XX-?---------XX------EE--MB---v
---M-X--E-----?----MX--o?X-BX-ME----oX-E----------XE--X----XX----o?XE---?---E--EoB-----B---MXB----XXX---X-------EXoX-BE---Eo-X--MMX--X---X---M-X---E---E---?---Bo-B-MXB------E-E--o------M--MXM-E-o----f
-EBM-?--B-----X-----BE--X-----o--o----B-B----------?-E--o---------XXX-o--E----B?-M---X-o--E-E-BE-o--X---o-----XX--?-oo-o--X---X-oM?X-MBX-----M-------B----B-E-M--o---BE---X--X--E---------X--X---M--BX-f
-X?-----B----B----?---X-E---B---?---o-------X-XX--E-X-----?B-E----o-E---EM--X-X?X------XXXo--X-E-XXE---X?--Xo?-oX-X-??-------X----E-M--X--BXEX--X--XB---E-------X-B--o-M?-o-M-M-X?XX------XE-----XoX?M-f
-BX-X-X?B--X--?-?---?-------M-E-X----?-MX-----X--?MX?X----X--EX----?---BX---------B-M-X-?-?-XEX-BB-------??-Bo----E-?-o?X-X--E-BX---BMX------E-??-E-o----M------------o--?X-XB--X-E-------o--?-E--X--E-f
---XXooEX---X------E-----Mo---M---BMM----XM-XEo-----E---X--M--X------M--o-EM-XMXE---M---?-?E-EX-o-?---X-B--?--?-----?E----X?-o?-----E----XEB---------?--o--------o-E----?------XX--E---o--B-----B-----Ef
-M-M----X----E-------EBEXo-----XE-o---o-X-EM-B-o-E----M-------X-------X?--XoB--?M----B--oo----MM-------X-X-o--?X-----?-----------?-B--MX---XE--E?-?o-XX--oX-----------E---E----X-----------M------?-X-Bf
m--M---M--?Xo?--B-B-o-M--?o---X-oB--------M-------B?--XE--oE----?----X?----oXX-----M---X----?--------X----X??---M?B-X--X-XM-?-??---------X-B-----o---MM---MX-B-X-?--X-BM--X-M?-M--o-?-----o-X--o-o----MX
XE-M--BX?---X-o---M----------B-MX--?E-EM-----------MX---?--o-MEE?B--BXBXXBB-o--?--?--EE-----EB?B-BEo--------M---B-?-----X??--?---o--E?------X---X-Mo---X----------------E?---B---------MMo-oXX-----X---X
