--B-XEo-o-XEEBEX-B-?-MX-o-?o-oXBEXMEX---XXo--oo-oB-E-XMEo-Mo--Xo-?X-XEEoE-X-BE-E-EXoM-XEX-?oEM-B-ME??X-XXEE-?E-EEXE-EEXEX---BEXXE?E?EEXX-X--XE-XX-E-X?M-EXEXXBE-X-EXX--?EEEXXE-EX-oEo---EBM--X-o-XX--EE-
-BEMBBE?o----o-MoE--oX-EMMEMoo-XEEX-X-o--XB--B--o?o--XBE--EEo--MXXM-oo--X?-oEEM-XXXE-XB--EEX-XEMX-E-oM--M-BEE-M-o?o-BM------X-BXoBB-o-oXB--?BEX-E-X--Eo-EBME-ME-?-ME-E---oEEXE--E-XBE-E--E?XXEXEEXMo-o--
-?-BE---oXoEX--XE-M-EMBBo--XEEoB--oXX-BBE-XXM-XX?o-X-XEEB-oEB---EX-oXXMBEB-ooM-BX-BB---EB---B?-BX-EE-EE-?Xo-BB--MXoXo---oXooE-MX-oX--M-XEXEX-o?X?----E-E--E-MXX-E-X----oE---?--XEEXX-EXBE-XX-ooEMXBE--o-
-BXXBXEE-Eo-X----EEoM-E--X-B--EE-oBoX-X-?BE-E-ME?M?EMEEB--EoX--MXBEX-oE-EEEEXE-EBXX-EXX--oX-EM?XB-X?EXX-BXo--BEE-EX-BEXMXo--o--ooXE----oX-EoEoEE?-------XXBE--B-XBoBXBXE-M-B--BX-E-o-EX-XEXEX--XE-B-oo--
--oBM-BXX-Eo-X----oXBXXE-oB?EEX?BBB-ooEXEX-E?--X-XE?XXoXEME?-XX-Eo-XEX--E--X-MEBMXo--B-B-oXE--B--oX--XX-X-BE--BXXX----EoEB--X-XEoEEoo-E?MX-BXXEBE--E---E-X--BEM-EBXX-EX-XXEEXM?MMXXX-B-XoX-M-?-EXX-oX-E-
-B--B-oBEo?XX--EXEX--X--XXE-B--o------E-----MBoBBXXX-EoXoE-EEX?EE-BEXoEE-?EXEE--E-?-EXX-?-B-EX-X--o?MXEX-MX--EE-E-EEX--M-oXM?-Bo?-BoXoX-XB-XX?-E-XX-XXoo?XEB-XEXXBo---BX-XEE--M-E-M--E-oEEMEBBoXMEEoE---
-X-E--MBEBEM--oEoE-BoBB-E?X-MEE--oEE---Bo--Boo-B--XoXXXEXB-XoEo-EE?---X-BX-Eo-BEXB-BX-X-X-o-EEM-X--BBXMEME-BE--B-X----X--MBoE-XEoXXBEBEX-BoX-BBE-XX--EXXXoX-oo--XEXXX-XEXMM--X--EoXo-X-MoXXBBEX--ooEEX--
-EXMXXXoX---E-X-E-EEX-M--o-XEM-?EX-EXMB-B-o--EE-EXXXXo---o-E-oX----BBE-----EXEX--XoXXXXBoEE--X-X-BBEEB?-E-E---oBME-B--?XB----XXBBoXM-XEXBEX---??MEB-BoEBoEE--B?----X-X-XXo-E-XXXoXEBX-XXX---oE--EM---B-v
--?-o-EM-X-BXBBX?XXEBX?--B--E-?XMB?--MEE---oooMX-BEXB--B-XE-MXE?B--X-BXBo-MX?-XXEE--BEXBEEEoE-XoX-EX-E-oB-EE-B?MX-o-XEX-?-oBE--BXXBX--oEXB-EXB-B-XXBEoX-?X---BBX?o-E?-Eo-XBEMMX-E-?--XEX??o-ME-BB?-E-o-f
--Bo--XoEM-EEXX-B-B-B-E--EX-X-X-BXo?EME----EX-M-BooE-MoMME-XXX-B-XXoXX-EX---?X-EEo-BE-B-XEEo?XXX-oXEEE-E?BE-XXXX-EE-???BBXE-BoEo?o-?MBEo--XEEE--B--XM-B-?E-EX--EXEoEEooEBB--E--oXB-BX--oXXEXXo-XoBE--oEf
-o-E-XXBXBBXE--X-oE?E-EXX-BoB-oXXEXBE-BoXB--oX-EBEXX-oXXoX-E-oEXEXoMBXoX----E-EB-ME-B----X--o--XEoBBoBoM-MB--oBM-X-E-B?-XE?BMo-Xo-oE-o--ooEBEEo-E?-M?-XE-BE-EooXo-X-XEoEXXB-EMXXEEEMX-XMEo-EEEEMooEEEE-f
-BB?EBBE-XE-XE--EB-BE--oX--X-BEoEXoo--?oX-X-E-X-E-B--M--EBXoE?EEBE?-EE-oEEEBX-XX-BE--B--BX?-XXo-?EXBXooXE-X?XEoM-X?-EEE-MX-Bo---E--B-X?B?oE-E?EMXXE--X-XBE-?BX---E-X-XEBBXEX-oE-XXX-E--BX-MEoB-oE-E-BBBf
-E-E--M-XEXBXXBEoXo-?-EBBo-BE-o----oB-oX-MX?XXB-E-XXEEoo--EE-B-BX---EB-EEE--oB-X--X-EX-X-BE-EXM?EE?EXB-X?o-BX--X-XEBEEM-EEXXoB-XX-XX-?BEXo--E-XMBB--E---?---X--?-M---E-XXEBE?-E-X-oMoM--EEXBo-EXBXXXEXXf
-XX-B----MB--E--XXoBEoXMXEBEX--o?-XM-EoB-XoMEE-Xo--EXoEXEB-BXE-X--X?E--EBXoXEXEBXXX---MEMX?-E-B--EMB-X---BEXBBX-oBoEMoM-E-XBEEEBM?MEM?E?-XXXX-EBo-o-EE?MXEEoEooE-XB-EEX--BBoE?-X-?Boo---X--XB?E--M-BB-of
mB?E----oEMXX-o-MB-X-XE-Bo?-MooBMBMEX-XoEXBM-E-BoX?oX-XMEE-BEB-E-BX-XXEBB--E-X?--oE-XXE--?XEE--XMX--MoX-E-BBEB-BoE-XB-B-E--E-EEBXoXEooXMEXEE-o--XX-oEEoB-Boo-oBX-XXM-EE?EB-E--XXEXM-----MoXE-M-B-M--E-BX
X-E-E-EX-X--BX--E-MoXEE?---E?-EX-Eo?XXEMBEMBEXXEEXXB-E-X-E---EEXMXoMXoMBEE--EXME?EEXM?EXB--XX-BX--XMME-XEXMo?-EX-B--XEEEX-E?EBE-EE-B?-M-X-BX-EXX-EE-B-o----X-X--BoXE-oXoEM--M-E?BX?oBXE---EBXX??EXX--X-X
