|-M-----o---?----Xo-X----------?--EX------?ME----------o?E??--------------X---?---Mo-o---EXEo?-o--E---M----?-B-X----E----o--?--?-E?oo--oM-E---B--??--??-XB-M---?-----?-X---B----B--X?-----B-o-o--EX-B--M
E-E-----B----------E-BB---?X----B--o--B-B--X---B---M?---------E-???--X---B?-------MXE-o---E-M----E---EB-X---------?-----B------?-B-------X---E-M---o-XEX---------?-----------------M---o----o?--------o?
M-------XE-MM-E---X-----------o--------X---EM---BB---------MBB-M-oBB-?M---X----X----E--E--o------------E-M--o---E---X?B--------Mo-X--?-XE--B-X-EM-----X-----?-?MX-E---B------B--?-E-B--BXo-Eo-?M--E--E-B
XMB?--o?----B-EB-o-B------M-----o--EE--??---X----o--XM-?------E--M---Bo-E-------?M?--MX---EX------M----?-----B--XB-X----oE--------E----------?--?-E-E-oBM--?----M--Xo-----------E-----X--E-M?---?-X-B-XX
T-B--E----M?M-E---?MB--E-M---------M----o-E--------M----MM---?------------ME---B--MX-X-o---M-B-----------------E--M-o---o?-B-----oE------E-----X---------?B--o?-X--E-oE--X-----E-E-BB------M-oo-oE-X---E
X----M-------o---BM-------XoX-MB----X-XM----??--?MBMM-----M--M--?--MX-E-----E--B---MEo--E-----?X--o---?----??-M?-?Mo-E----M?---EM-E----?-----?---MM-X-----E---------------BM---X-----------BX---B--EME-T
TME-o--?-?--X?----X--------?------B-MEo-------?----------XEM--------E---M--X---------?---------M-M---------oX---XM-----M----??-?----------BB-------------------M-M---------?--M---E--ME--ME?--M---M----X
|--------X--oX?----MM-----M-EEE------------E-M-E--?--?--E--------o?-o---E-----B--?o--EB---M-o?oo-X--------Xo------o---?X-E----X--------E?---o-----Bo--EEo----?-X-o----X-M----BE---?---B--BM----B-X-----v
E---?------?o----?o-BE?B--o--?-?------o-?-o----B--oE---EX-X---E---o---E--?----X--X-------------EB------E--Mo?-------E--XEM-M-oE-?o-o----------E---?--B------?Moo-----B---M-----------?E?M-M-----M---?---
E-----------------X---------XM-----EB----E------X?oM-Eoo---M---X----X?-EX-----o-----BB------B----E--E-o-E-----?E-?--?----?EX-BB--o---EB---------Bo-X--?E-----?---oX?X--X----B--------E-----Xo--?-o--?M-M
Xo---E-X-B--E--B--Mo-B-o---B--E---X----M--------B--X----XX-X--B--?-?E?-B----E-----M-----Mo---------------?-B-------X--??--X--?---Eo-----X-o-M--?X--?--E--M-E---XE--M-M-----Bo----------B------BX-------T
X------B-------B-----o-----B--E-o-o?-----E----X---------M----B-----M--X-oo-----E--B--B--XX--o-------E---BX--XM------M-B----EoM-----oMB-BX----?-M----M?-----M--X-o--?---M--E-EX---X--?--MMX-MXM--------B?
?--BB-?-----------M--M-----o--E--o-----B-M-BE----------M-----------X------E--XM-B----B-E---?----M----o-----?-------oM--Bo--B----oo-----X-o---BB---o--XB-?-oo--XE----BEB?-BM-----X--M---Mo--?M--B?---MX-B
M---B--?----X--E-----M-----?X-oB---X-----?----Eo-M-?--?----XBM-----X----M-o-------Xo-X-----??--B-X--o----?-B?-oB-?-ME---------------Mo-------B-?-XEXE---E-o?---B?EM----E-oEX---oXMEX-----X----E---E--X-?
m--B----E--o------o----E?--------M-B--XM-----M-----M---X---?--?--M--?----X--?--X------E----?----oX-M?--oMM-B-------o?--------E----B-----XM---?E-M---E----XB-MM---XE---E--M-?-----?o-----BBo-XE-?-------T
XXXMXXXBXXXXXEXXEXXEXXXoXEXX?oMXXXXX?XXXXXBMXXXEXXXXX?XEBXXXBEXXXBBo?EXX?XXBEoXXXXoMXXBXXXBEXXoXBXBXXBXXXXXBXXBXXoXEXXMXXXoEBXXXX??XXXXXXXXXXXXoXXXXXEoXXXXXXBXXXXXX?XXXXXXXoEBMBXXXXXXoEXXXBXXXXXMXXXXX
