---X--------X-------------------X---o---X--XE--------X----------X----X--------X-o----E--o-----XE-o----X--------o----E----o----E-----X-------o--------o----E-------E--E-----o--Xo-------------o----------
------------------o-----E--o--X------E----X-X--E--X-X---------X-----EX------E-o---E--E--------------------X--o------------E---------X-Xo--o----EX-E----X-----E---------X---------E-------o--Xo-----o----
----o-X----E--E-o----E---X---EX---E--E------o-----o-------XE-----------o----o------------X-EE----o------E--------o----E-o-oX--o-------X-----------------X-------X------------X---------E----------------
-E------------X---------X--E---E---------X-----------------------X-o-------X--------o-o-o-------o--E-------------E---EX----X------X-------EX--------X------E-----------------------X-------E-o-X--X-----
---E--------X-------o-X--E-------------X----E-----X---o--o------X---------------------X-------------------EEE-------Eo--------oE---------o------------E-------------Xo--o-X-----------X------XE-E-------
------o---X------------------------oX---------o----EE-----X---o-----o-----o--o--------o---oo-----------o-------E-oX--------------------E---X-----E--------o----X--------o-----EX-------X-----o-E--------
-------E-EX-----E------o-XXX-X---------------------E----X--o----------------E-oX--E--------------X----X-X-E---E-E--o------o-E---E-EX--------E---o---o--E-EE-------o-o--o--------------X--o----------o---
--------E--E-o-------------------E---X--------oEE----E-E--------E----------E---o---------X--------------------------E---E---------------o--EE---------------EX-----E-------E----------E---E------------v
--?EB-Bo---------------B----MX-----?ME?o?B--MX--Eo-X--X----B---------oB---X----X--B-------?B-----E----E---------------oX--------o----M--?---?---o--X-EXo---oX---XE-M--?X--E--X--X-M----B-E--XM---MM-M?-f
----EB-----M--B-XM--------B---oo---M--M-----XE?----B-----MMM--BEoM--M-----B-?--------o--M--?---o----M--B?X---?-?B?-----------X-BM--E---------M-B-----o---------BE--?-BM--o-M----B---M--X-M--XX-?---M---f
--B-----X-Eo-EXE?--???E---M--o-o-------MMo?-oB-----?----M---E--M--BBB------?--E-Bo---o----?---?-EB-oo----E-?E---o-Xo---M-o---------o---X-----M---B-----------X-----?X-?o---?M-?-X----?--B-----XXo--BBB-f
----ME-EM----M---BBBo--------B-X-E--BX--------E--EoE-?M-E--?MBM--?-?---?-B----------E-X----------XM-X--X-------Xoo------------BEM---E--------EME-EB------M-M---oE---B----M-----M----?-B-EMX-EM-?X-X-?--f
-----X-----B-----X----B-E---X-?------B-E-o----X---?---B-----o------EBBX-M-------X-?------XXE---?XE---M------o-X-----B-----?-?---------B----B--EB----?MB----?-X-?B----MB-o--XE--XE--X-o----E-BX-M-XBX--of
-------?-BE--X---E?M--B--------o----B-----X-ME-X----M---E--EM-----?----o--M--E---------o-------B--M--MX---??BBB-?--?--M-M--o---o-------o--E-?--X--X-------M---E-B-?--BM-o-------M-oE?------?E--o-------f
m?--M-M------E-------o---?-B-oE----X-o-E----------------?-B-o------B-BX----?-------MEB?-B?X--o-M-oXM---B-o-------M----o-?X----MM-------B-ME-?---Boo--??----M-----X-------M-------?Bo-M-Bo---?----X-----X
XXMXXMXEXXX?XoXMXXXXXMoXXXXXXMXoXXXXXXXXMXXXXXX?XoXXXXXMXXoX?XXXXXMXXX?XXXXXXXXXXMXMXXXEBMXXXXXXXEXXXXXX?oMXXBXMMXXXXXBBBXXXXXoXXXXXBXX?XoXXXXXBXXXXXXXXXBXXXXXoMXXXBEX?XXXEXXXXXoXMBXXXXXXXX?oXXXMXEXMX
