B-M?--------?EEB?-----?-E------B----E--?---E--------E-----------X-------Bo?o--X-o----X?-oMo-----?-------?---oB-M--E--B---------X-------------M-----oBE----?--E-E-X-X---M---------B------M-B--o---B-----?
?---X-----?Bo-o-X--?M---------------oM----B-E-----E---X--?-E-B--MB-X----o-o---XM---EE--B--B-------X-E---------o---------oE-?---EBX-----?--?---o-o---X--?--E------E---BB-EB-----XM---------------?------?
?B-X?--M-------??---------E-X---------X--------Mo-B-??X-o--B-------M-----E-X-B---M-M-B---------M--M---o----?--Xo-oX-X----MX--X------------?---E-----B--o---o-----------ME--M----o-B----?------o--M-?-M-B
X-E------X--?--o-E-----Eo??-E----------M-----X---M-X---E-----E-?-----MEo--X------BM-M??---M---------oX----ME?-o-----?---M--XX--?---MM------------EMB?B---oo--------M---M-----o-?M--MEM-Boo?---M-B-Eo--M-
o-oX------------B-B?---------------B---?-XEE--M---M-?---o----o-oXM----o--M-------M-B--------M--M-E----?B---X-Eo---M-E--?---o-MX--M-B?--o-E-X--M-o----M--------B--?------X--XEB-B--?----X------o---------
?-----X-o-M-B-E----------BE-EB------------M--------X----?-?-----------M----X-----?----EE---?----------MEo-EX--?--------?BMX-Xo---??o-?---B-B-XEXo-B---?E?----BBM-----M----B---?--M-BB-------X--------M-|
X---B--?--?---?-X-X------?-B--B---ME--?--M-?-------------o-E-EE----?----E----B-----E-E-X-Bo-Eo-E--------?---o-oM--X---X?--o-MM------B-?-X-----?B------oX--M?---X?--?------E---BE--o--M--?EX-oBX-?-B-B--X
M-o------o--o-B--?-?------X-----B-------o-E----------X----------E--o------o----oM--------E---B?----M----XB-----M---X---Mo-E----o--?oE-----?ooE---M-----Eo-----?-E-E---BE-MB-o---EX--?---B-o---B----E---v
?--?-----B--------o--E---o----oB--------E-B--B---o-M---?B-E---?-----B-------XM------?o-----o--M--------EMX-----B----B----?----?---o---B--------oE-oE---M---M-MM--B-----oX---M--E-B-oM------B---?X--Bo--E
X-----E-------------XoXM--EMo-E--M----o---o--------B?---B-------o--X---X----M-o----?---o--?----oMo-o--------?--B?-M---XM--o--?o---?-o--M-------M---B----B--o----o----M--E-M-o-X-----------------E--M----
|---oB-oB?-----oM-----oM--o-o----M-------B--?---------E-?---?oX---E----M-?-EB-M--o--X------B----?-------BM-Mo----M-----------X-XM--?-------M-X----M-----?-E-?X-XXB-----?X-X-X?X-X-?--------?--o------E--
?-E----------E---X---X---B-------o--X--M----?-EE?------------o------o-?--X----?o?-E---M---B--B-B----B--?-----------M--E---oEo--o--E---?---E-?--------B-oME--X---X---X--?-------oM--oB----MM--B----?B---T
o-XB---B--X-BB----X----------X-X---E------BX-M--E----M-------EBo-BE---E?--M??--?-E-Xo-------B-----B--E--EM--?-X-X--o?--o---EE----?BB-MM-M-----M---------------XXB-B---MM---------?oME-o----X-M--M-MB-o-T
M----?---?----E--------X---B--E-----?-Mo--X--oX---B----B-----X-------E--?--B?B-M--X--------o---B---?--X--M--XE?--o-----E?-?-?---o----Mo---oX--M-o---?B--o----B-B?--X-E---------?-BX----?M--?E?-E-?-o---o
m---o---M-oB--EX---M--T---TE-?B--TE-------M---M-E--o---B-E-M--?--B--oo--?-XB--M--------E-E-M-----------?-?--T-o--B-XXE-----M----E-E--T?-M--Xo-?-X----M-E-Xo-MX-Eo--E-M---------B------T-------X?--BBXT-T
XXXEoXXBMXXXXMXXXXXXXX|BXX|XMX?EX|oXXXXMXMXXXXXMXMXXBXXXXXXXMXEXXXXXXMXXXBXXXoXMXMEBX?XMXXoEXXXXMoXXXXXXBXMM|EXXX?XXXXBXXXXXXXXXXXXXX|X?EBoXXXXXXXXXXBXXXXEXXXMX?oXoXXXXXXXXXXEEXXMXMX|XMXXMXoXoXXXMX|XX
