-------?---B--X---o--E--oM------o--o-E?-----X-?-E----X---------------E----?-?o-E--E--oM--B------o----M---X---M----M--o----X-X-oXB-----E-Eo----------------B--E-----------?--oM--M---o---o--o-----B------
-o--------o-----oM--BXM-------?------B--?--B--M-----------E--E-E----?E-------------?----------M?---XB--------?--M-X---o--?--o-oX-B----?X---E--oB--?---BE--M-Eoo--??oE----M------E-o--X?-o--?----E?M---B-
--M-oEX------?--X---------o?X--??---Mo---?o-o------?-o---E----------X--?-E?------BM--B----M----o--o---o-E?-----------E-------X--B-----E--MX-------E-?--M---Mo--E-B---BE-o--M?-------?---E-XMX-----------
-X-?M--M---M------X?MX-o-o-----?--Eo----------M-B-----------X----Eo---E----BE-----?B-M---B-oX?----E--X--M--X?----------M---E-?------?M?B--ME---X------?-----E-?--MM--M?E-o-----o---o--------?MM--X--X-?-
--XX-M-o-o-----B-?--M-X-B--?--o-B-?Eo--X---B----------oM---?---B--E--BB??-B------EMBBX-?XB------EXoE?E-M----B----?--?--XXoX-B--------------------X-E-EBB--B-M---E-B--B-o--B-X--------E-?B?X---?---------
--oM---------MX--------XE---?X-X------EBB------M-------?-Bo------EX--------?M-BX-X---o-?E-----E--?X----B---------------B-?-M------M--E------B-XE---E---E-Xo-?--EE------B?X-------E--ME-M---M-----?M--M?-
--B--M-?-?XE---o---M--------EXB-X--oo--X----------X-M---B-----BB?o?----EXo--Eo--Mo---?-------E----o--------E----------E---X-XB----E-o-E--X----?M--M---oXo---E--B-------X---E?X-----?o-----M-----B-------
--X---o------?--BEB--o?-oM?-X---X--?---M-B-E--XX--o----BBM-?X---MM------oM--?-EX--o---E-X-M-M-XEo----EE-oX-EEX-X--B----X--X-o---??----M----------M--E----EM-ME--M-----BX--o--E-M-E---M--?EE--M--------Ev
---o-MX-EBBE-----BE--oEo--MM-----?-?---------------XBEE-o-o-B-o---?-E---E--o-BE-M--E?X-----------B-?-----X-E--?-----B-?---X---EE----?-----M---?X---------oo-E--X-E----------------o?----X----o-X-----o-f
----MX---EX--B-?M---EE-X--M--?-E--M-M-B--oX-E-X------E-X-E--X-o---X--B-B-BM----M-----------o---E-------Bo--M----B-EXo-----E-B---B-B--E--?EM--E--------------B-MM------------XM---------Moo--MoX------Xof
---M-XB-M-?--ooM----E-------o---EB-----?M?X-B----E---Mo-EX--------M-o---E-X-------o-M--X?-----------M--MB--M?X?------X-----Mo------M--XM?----EX----?--MX--M--?-----M--o-E--oE---MX--?-X-----X??--oEoM-of
----o-X-----o-------X-o-?--X-B---X-X---------o-oE-----------?o--M?--M---EB--?------------E----E--X-M-?-----X-X--o--E-?---EB-----M---EM---------B?o------BX------?--MB-B-BXB---o----?E--M-oX-oE--o------f
--EM?E-----E--o-------EX--?----o?---EE-------?-o--------M------o--M---------E-o?BE----M--E---?o--X-o------oE-Eo------E?----?-------M-M-?-X-?-Xo----?MB---?-?MoBB--oB-B-E--XB-----MME?-M--M-M----?X--E--f
---B-?-----Bo-oX-B---E---BE--BM---o-X---B-B-------MM--o---E-E-----X------?-M?--?---Bo-BE------------?---B---X--o?M--X-X---o--?---E--XXB------E--?--o--M-E----oM----?----B---X--o----B-----o--M----?----f
m--B?-XT-B-E-X---E-X-------X----EE-----E--T----E-E-M-E-B--EBT-----M--o---M---M----?--?T?T---?B?T?E------M----B---M-X?--M----?--------E---------TBT?T-oT-Eo??XToo-----E-M--M-T---?--M-----X---T-----BT-MX
XXXXXXX|XMXXXXXXXXXXMXXXXoMXXXXXXXXXXXEXXX|XXXXXXXXXXXEXXXXX|XXX?XEXXXXMXEX?MX?XXXXXXo|M|XBXXXX|XXXXXXXXXXXoXX?XXXMoXXXBXEXXXBXXXXXXXoXXoBXXXXX|X|X|XB|XX?XXX|XEXoEXXXXEXoXX|XXXMXoXXXBXXXXoo|XXXXMX|BXX
