--o---------------E-BX----------?-??XB------?o---X-B?-----X--B----E--BX--?----E-----?------------o-o--?--o-----------B-EoB--X--E-XBX-M---BX-E-E-----------B---?-----M----o---X---X?-X----E-BBX-------XE-
--X-MXM?-BBE-X-----B-E-o-------?X---B-----------Bo-?-----BM-------MM------M---------E-E-?--M-----?--X-?M---B-XBo-----B-oo-?-----?--?--E-E-o---?--o-M-------X---?---X?---------o--oE---EM-------?--?o----
---oX-oX--------X-B-?------X-------o--E-X---X------X--------B---?-B--?----BM-------M--X-?X--X-o---B--M------oE---o---?oo-E--------M---B--E---B--XE-----oE-?-X--?-?-----?-E--o---------XE------o--EEM-?--
-BMo--oE?-----?o-B-?MXo--?--XXE-----MX------o----E--oM----B-?-MB---?-o-----B----E--BE-oXM---------E--X---oooEX-------o--MX-------?---oE-----o-?-------o-?-Eo--?--B------B--------B----E--o-----?E-?Xo-X-
-----X-E------X-E--M------------X?M---o----B--M---E--B-M---B---X------M-X-B---M--E--oE-E?--MX-EB---M-M--Bo--M-o--------M---X--XM-------B-E--------------E?M-X-?---?Mo?----X-------MM-X-----?E-E----X-o--
-X----BB---B-?----o--o-------oB?M------Bo----o-B----MBXBo--------------?------E?B--------oX----X---o--XE----?-----E?EX-----o---B?X------X---EMB---Bo----EX------E-E---B-?--o?XXXE------X-Eoo--B---MEo-M-
-o--------X--E--o---E?B------?------X-?Mo----------B-------Mo---M-EM---MX-M-?---E---M--o?E----B-----M------M?--X-M---?--?-----EEBB--B-----o--B--?-o-------o-----B---o--Mo-------X-ME?-X?-M-B----E-M-----
-M-M----EE------?--B-B?------?BX--M-----M-Eo---X---o---o------------B-o--?-----XX?-E-X-o---M-E--B?---------E-XM-------M---B-o---M----Eo--------?M---E---EE---B-X----o---o----E----ME-E-ooo------X-----ov
-----E-M-----M-oE-----M----EM---X------BXX-M--X?X----?---B?-B--------X-E-M-?----o---E-X---------X-----------o--E-----M---X-----Xo------o----o------M---X---------?M-E-----------?----E-oX----X----B-BEBf
--------M-B----------------E---------X--E--o-----------B-B-?--M-X---EM-----B---------M--E-?-----------M--B------------o--?B--?--XE----??-M----?----------M?---o----------o-----E---MX--------E?---?-E-Bf
-oM-----X---??-E-E-------MM----B-----------Mo--B-------o---X---B---------X--EM-EM---??-oM---X----?-XXBM---B-----oBo?X?----------oE-M-?--EoEo-B--------MBEBX-------B-EX-M--B-B-oXM------XE-X----?-------f
----X--------X-B--??---------B-XB----E-?---B-XM-----o-------o-B----?-------EM-oE-o------M--?--o-B-------?------M-M--MB---?--o--E-oXX-B----oo-M-?--X--o-------E------------o-?--Boo---E---o-o---M?M--B-Ef
-EMM---?o--E--MoB-----o-E--------E------X--o--M----o--XX----?---X--?-B-B-X------?-M-------MB-E?o-o--EX-M-M--X---XM-o---E--oB-----E----?---?-MXE-------EB--MB----M---o---X--B-o-----B---Bo--E-----E-----f
--XE------------BoB--BE---B----EE--B----B--??--E-??E-B---M-----------X--?---B-----B--------E------MX--EM----o---oMo--EE-o----?---XM--E-B--B-?-B----E---B-o-------X-M--?----?------B?-----M---------M---f
mM---E---?o---o-M--?M---------E-----E?---E---o-M-MM-----BM---M---??---X-------B-------E-----oEBX---o---------------EBE--------M----?----------?-BX--?---X-o-----XEXo-ME----------oX---Xo-B-----o?-MX---X
X----B?---------M?--X-----M------o----------B--?-------o------E---B---?----?-----X?oX-B--?---?-?--EXo--o--?M-ME------M---E-o-o-----Eo---o-----oBX---X-M?-E--o----?-B----MXE--E-----?X--EBE---M?oo------X
