-----E-X-E--o--M--X?-?EMM-?--X-------ME-----XM---o---EB-----------M--------E?--XX--EBB-------B---o?XM-E--oX---?----X----o--X---B--XM--E-B-------o-?-?E-B--------X-BM----EBE----E--EoM?oX----B-XB----B-X-
----B-?M--M---------EM-B--?BE---M-X---------------oE-?--M---X-o-B-----EE----o?M-M--o--o----X-Eo-MEE-----?BB-E-----XM-X---E---?----EBEE--------BMX-----X---M-----M------?-?---oME--o-E--M----?-------E---
-BE-?M-E--X-----o-BM-B-oE-----E--B--M-----M----E---o---Eo----E--M--M-E---?M---o---o-MB--E-E--M--M----E---------B-??-o---------M-?E--M---o----------M-?-?-E-?-M--X-------o-Mo---XXo---B-----------?B---o-
---B--E-oo---B----M---MB--------B-B----?-----o--?----o-----ooE----?---ME--X------X--oE?B-----E-E-o--B-E-oo-o---X--X-X-Eo----MM-?---------------Eo--E----o----?-----Mo--------E?E--o-?---o--------o--B-M-
-----M---X-----E-----------X-Bo-MX---oo------EE---X-MM--------E?M---------o--B----------------M-B-o----------X---o-----M-M-E-M---M--X?-E----o?E-X-----o-----M-------------oo-M-----M-o------------?E-X--
---?---B-?-?-------EX----Eo-?--M-X--X-?----M----E---XM---Bo-M--M---oE-------o--M-----------?-X--??-E--?--?----M--X-B----o-o---?---XE------Mo-X------o-----o-------EE?-E-----------o-M--B-?---?--X?Eo----
--o--o-Xo--EM-------BM--B-MM----EB-E--M------o-----?-oE---?M-?----------M-?--M------o--?E----B?--M------?-o-E-?--E----E---?B--E---MB----oBM-B-?X----E--E---M-X--B----o-o--X-?MBM--X-o-o---------------B-
--o----------?-------M-B----E-----------?--BM-X--M--B-----M-----B----X?-X?--M-B--B?E----E?--?E--X-----o-?MX---o---B-X-E?---?-MM-------E---Bo--B---X---MM---X-E-----?-B---o-o-M-o----?--------?--E--E---v
--------X----?B-E--EMoB--BX-X-M---XBB----BM--E----M-M-o--o--o----B?-?------X----MX---X?--------EMM-BB-M--E-----M--?---X---?--E---M-------E-----?-----Mo-?B---??--X-----------?-E-------M---MM-X-o--B---f
---o------o--o-M-----X--B-E---B-----X-B------------------B---------------Mo--M-----M----X-?--B?----o--M----Xo-BB-M-E--------------?---?--?----?-----------B-E---o--X?B-------o--oE----M?--M--E---------f
-B---E--o---------o--MX-M-EM-EM------o-o--E--?-B---E-MMM-M-X--M-------B---MM--?-?oMX--X----X----?ooE------MM--oBoBE--------o--BE-E-----X-----X------?X-B---M--o?------?--M----M------Eo----------E-X-M-f
-X------o----B--B?----E-E-E---E-ooX--?--E--?------------BB-o-----M---M--X-X--o---B------------M-----?-----M--Eo--B-B---X--?---------------E---BE-B----E-M--M---BoBo??--oM--------?--?---B---o----o---Xof
--E-o-oo----Xo-X--?M----?--B-------?---X-o------B-----M---MM-E-X-E----------oE-E----?--BE-----E--?-B-M--X--?-----E---------X--B---MB--XE-----E--M--?M---o--X----XE----B----?---oXB-----B----B---X------f
-------X-E--B-?--M-----??-?---------M-?-E-MX---MX-----E---oB-X---?-------o-M----B---X--E-XM-----M?---XB-o--X-X------B-o----------EM----M----?----o-E--B----?M-M--B---?---E-----M-E---X-----E-B---M-----f
m?--B-o-X---X-M----X-?o?--------X-----M--o-----?-BM-M---o----o---XX?o-E--EB---BoE--------X--B-------o-B---------oM-E-----------oBo-----?--B--XBB---?-------?o---BM---M--oEo-E-------?--------?--o---M--X
XXXXMXEXXXXXoXXMXXXXBXXXoXXXXXXXXXXXXXXXXX?XXXXXXXXXEX?BXXXXXXXXXoEXXXXXXXXXXEXXXEXoEXXXEXXXXXBoXXXBXBXXMXB?XXXXBXXXXMXXXXXXXXXEXXXXXXBoX?XXXXXXXXXX?XXXBXMoXXXX?XXXXXBXXXXXXXX?XXX?X?XXXXXXoXXXooXXEXXX
