---M------ME--E-------B--o-M----o-X---?-?BX-?-------------E------B----o-M-?E--o-----oM?B-oX-----o--oEB--?--BoE--------?------------o---E-----B-EM-E----o-E--oB-----M--B-XM---o-o-?----E--X--------------
---o---M------EX----E-M---M------?E---BX---M----------o-o-----?---------MX-M---E---oM-oX-EM--oX---------?M-B------M-XE-?MMXE---B---o----EMB-?--?------B-E-----------E--------M---------B--M-o---E---MXE-
---M-----o----o-B----E?--------B--B-M-------M----M---X----B---XM-------X-----B----------M--X---B---E--o-----ME---------------B--B--o---oM-E?E----B----E--------EXM-E--------MM----------B--B-------o--E-
-X-----E------E---------B-----X----M-B-XE----X-----X?-----o-----oo-X-M-----E--B-M----?--E----X-E------?-E-M-B??--B-----M--BB-----------M?----o-E------------o?--M-E--E-B----E-----o-M---o--MB-----------
--M-?B-o--M--E------X----?-B-o--XEo---B---B-----------oX------?B?----?---M?-?--X----EM--E--?---o--E-BM---M--E---B---M--o-X?X---B-E---M-?-------?---o--?---------ME------oM?-?EE----X-BX--B---X----B-Mo--
-B--M-----E----o?---------------M-X-E-MB---E-X---o-B-E-B?---------?ME--B-XXX-X---------o-X---M---X--E---X--MM?--oX--?X------MM?-----EX--?---?-o?-----M---oE-o---X-?------M-------M--X--X-----M-o--B-----
--Bo----E-?--X------?-o-XM----?--oX?-------o---B-?--o-X--M--o-------X-XX-B---EE--B---------?--B---------BBXo-----MXB----------M-E----B------X-MX--oX-----M--EEE------X------B-----------o-E----?----B-M-
--o-?-o--------o---------ME--E-X-B--B--?----o--Xoo-M------o---X-?E----X---B---M--M--E-------X---M----M---X--E-o-----?-?-?-------BEBEE-o--B--B----MX-M--XBM?-E-----------o-B---XM------E-M-?-------X----v
----oB-?M----Bo-B-MM--------MXM-X-?-----?--MB--------X--------MXB-M--oE?o--o-M-MB-B--X-X---E-X--?o-BM---E--------B-MB---------M-----X-----M-----------o-B--o--X-M-------o-----?-------E-----?X--M--XE--f
---------------X-------?------?--Xo---?M-?---------E---oMo-X-EXX---ME---EX-M------o---Mo---?----EE---o-BB---BB------??------?---M---X--X-o-X-EE-B---o--?-EXo--E-M--X---B--X?--XoE----?--X-X-E--E--B--oMf
----E--?--B-E-----o--XB---X-----XE-??-----B---E-Xoo-------E--o-------oE?--B-----E---M----?o-?oo--M---E---E---Xo-X-------X-X-XB-------X?-o--o----?--X--o-X-M--M-?--B-----X-M-?---E-B-----Eo--E?--oE-----f
-----X-X--------?-E-------B------------?-----o--X---?----B--o---MX-----------Bo--X----B---M------------BE----M?B------E--o------------------?--M?-?----Xo---XB-----o-----X-----------B--B-B--EMM---E---f
--Eo--M-XB---Xo-M?o----BE--M------------E-?-X---------E-----o-oB-EXM--MX-?--E-o------oX------ME---M-o-o-?B?---------XE---X?--X-----------?--oo?--o-----oE----B-----E-MB-E--?-?E--M-E-------M-----M-?---f
-----E--XE?--o-----------------?--E--EE-M----E----E----?-----B---E--X-----E---o-BME-------o-X---BX---ME?--E?-B-M------E--X-E--M-X-M-------M-o---B-o---X-----E--X---E---E---------E-B-B---Xo-o-----M----f
m---ME---EM-oM-----TE----E-T-oE-BT-MoM----T-X---o---X-BoB--------M-----X--X----o--MM?--X-oMET-X----?--o-T-E-----EoBXT-B---------B-----?T-T?-B---?-T------------M----B--o--o-o----T---o-T-X-?T--EB?---ToX
XMXXXXXXXXXXMXXXXoX|X?XXXXM|oX?EX|oXXXXXXX|XXXXXBXMXoXXBMXXXXXXXXBXXoXXXX?oXXEBBXXXX?XXXXB?B|MXXBXXXoXXB|X?XXXXXXXX?|XXEXBXXXXXXXoXXXEB|X|XXBXMXXE|XXXXXXXXXX?XXXXXB?XEXXXoXXBXXo|XXBXX|XXMX|XXEXMMXX|oX
