--------------------------------------------------------------------------------------------------------------------------------------------------------------------------------------------------------
--------------------------------------------------------------------------------------------------------------------------------------------------------------------------------------------------------
--------------------------------------------------------------------------------------------------------------------------------------------------------------------------------------------------------
--------------------------------------------------------------------------------------------------------------------------------------------------------------------------------------------------------
--------------------------------------------------------------------------------------------------------------------------------------------------------------------------------------------------------
--------------------------------------------------------------------------------------------------------------------------------------------------------------------------------------------------------
--------------------------------------------------------------------------------------------------------------------------------------------------------------------------------------------------------
-------------------------------------------------------------------------------------------------------------------------------------------------------------------------------------------------------v
-------------?-?------M----ME-----M-B---------X-X--M-------Eoo--X------E-E-E-EXoX-----BE---B-X--o-BXM-------------?-------M---M-M-oo?--oB-o-------------EB----B---B-XoBM---B-----X--X-B------X---M-MB--f
-EX-B?--------o-------B--M-B--E------BE-BX------X----o----?-EEoB---------MEEE--o-X--------M--M-?-o-----o-----oBM-EoE-----M--M----E-E------X--B-B----XM------X---?-EB----o-B----o--X-o--E-?------?o----of
-----o?-----B--?M----X------MX?ME----?X------oo----oX-o--o------M---B-o-?--B--BEXB--EE-Eo------B?MB----?----o------oE-----M-X-X--------E----------X-M--B-----o-E--oX----MM--X----X-------X-E--o--M-----f
----?----o-----?--B-----B-----E---------?E---EX----?----M---B?-MoX---M-------??o-oX--X---------X-----o----X---------------M--EM-E---------MM?------E-Bo-??--?-BM-B------------B-E-X--o-E-o-X-----ME----f
-----B------B-B---M-oM-X--E?----?M-o---B--XoX-XM-B-XM-X--Xo-B----o---o?-M----X-----X-E-XX---E-E---B------?--B--E---------BB-X---o------?-E-M----XX-----M------ME--X--------M---o-?-X-----EM---?-----o--f
----B-E-B?-X----E---X--M------E-----MoM--XX-X---B--B-BB-----?-----X-----M-ME---E-X---B---EM-X-E?---X---E-o----------B-M--B------XEX--?-?---X---?----oo-----M-BX--?-o-o--?---------?--M--o-B---o----M---f
m-M-----X---EB---B-----o-o-??--E---?--EB---X-oMoM--?--B-X-?----------oX--B-E-B-o---M---MB-EEo--BBo--B--BM-----?---E?---------o-----?MB----EB----?-----E--XB--o----?B------o---X-MB--o-------?-o-----o-EX
X--M-B--E-----M--M---oo-?------X------o-XME-M--X--M--M---E----M--o--------Xo??--MM------Bo-------?oX--X-E------B---X---Bo--M--E---o--------?X-?-----?---X---?-----M--E---M-?----oX---------BEo---B--X-BX
