-----o?------------?M----o-----o--E------------M?X--?----o----B---X----M--B?--E------E-oB----------?MB--B?-----Xo-E-o---M-o------MMBo-X-----M---------X--X-----EE-----B-B-M------B--o----?--B-----?-?---
-----E-MX--------Xo---------E?--o----X---------o---X----MM?-?--EE---M--oEEE--------o--?Eo----------E-Bo----X--M---X-?--EB-B------M-o--XMo-X?-------?--o--------Xo-------?-------E--M----------E-X--?----
----E-o--------B------o--E--X?------B--o------o--B---M-------X-o-----?B----EBMX--------B?E?E----E--EM---XEo-B-M--------M-MX?o------M------?--oE------BEXMX-M-o---------X-------M-E---XB--oBE----MBE-----
--XEX----o-EX-----B------X-----o--------------MBB---MM-----Xo--?--X--EX-B-M-ME-----------Eo---EoEo?----B-o--M----M--EM-X--X-X-E--?---?---M---X--o-------Eo--ME----X-------B-X----------o---B----Bo-E?-E-
----o---------M-B---B?o-B---B------B-?-M?--E--?-Xo-MM--o------E--MoX--?X-------X------B--E---?--B?-X------M-------M-EM-----M--X-M---M-----?----?M----M----------------B-----o?o-X---------Xo-M---XM-----
---X---?-----E-o?-----------M--------M--M?------?B?----?---M------o-M------XoEo----?-?E---E-B--o------MX-EX--------XB?----?----------B--------X-------B--o--M--B-M-E--EX---MB-oE?-----E--?----BBE--B-MM-
------oXo?M---M------BE-o---?-?--B---E---B-X?--XM--B---M------E--X-E?--B-----o---MEB-------------MXE----?-?Eo-oX---MoX-----?------------------BM-X----?----E-------oX------X---E--M-----?-----B--?------
--------o?--------?--X--------B-E-?-M?---o-----?-B--------------B-BM----X-----BX-X-X---E-------E------X------?---------Eo-----BX-----M-E-----o--oE-----EE----?--M---X------EMB----M--X-B--X?-------B-BMv
-----o-?-------?E---M--M---X-B-MM---X--oE-------Xo--X-?--oo?--------------E-o-----Bo---o?o-X----E----------o----X-o--------B-X-o---E---o----Bo---M------MXM----------M-----------M--B-?---X---B---B-?--f
-----E---B---E-----o---ME---MEo----oo--??B----M--MB----------?-?--MB--o------o----B--?---o?----X-------o----oM-BM-------BE---oo----o--------o----?-o--------M--?--------oE--X----o-----X-XB--B-M----X--f
---M----X-M-------EEB---EB----?M--E---------E------MB--EE-E--M--MM-B-M--E?B-ooM-X?X-----------M---XM-BM--B--X?E-------X----o------B-XB-?o------B--BE?---oB---B--B----o-----o-X-M--MM----?---o-X----X---f
-o--o-M----Xo-BB-o-XBX-M--X-?-------M----?-B------------B---MM-oE-----E?--M---?M---------o-BB------E--------X--?E-X--M--B-M-o------E-----?--M-BE--------o?------MX??-E-Bo--oX?------M------E-------?-E-f
-E-------???---?---BE--E--------EX-?-BXB--E---BX-E-o---B--M----o----B--Mo------------E?--B--E----ooX---X------X----?--E------E---------B--X----B-E?-B--XM--E-o?-E-X-X----X--o--------XX---?--------M-Xof
-oE--X---M-------M--M-E---E--?--?E---X---------E--M-XM------X---o---E---X?oo----B---X----------------B-?X--M-B--?----?-?-----?-oM----E-------X-X-?---X---EE--------M-XE-BBB-B?-----?------------oo--B-Bf
m-M?-To----?--TM-E--T-M?--E-------X--T----M--?T-?Xo-?-----?o--o-----B--oE-MX-B--E---E----B?----TX--X------TB---E-B-M---X-oo-----------oM-E---o-o---oB?-EB-o------?o-----TT--E---ETo---B---X--X----XMX-BX
Xo?BX|XXXXMXXX|X?X?X|XEXXXXXXXXoXXoXX|XX?BoXXX|?XoX?XXBXMXXXXXMXXXXXXEXBXEXXXE?XXXXEXXXXMXXX??X|MXXMXXXEXX|XXoMXXXXXXBXMXXXXXXXXXXXXE?XBXX?XEBXX?XoXXoXXXXXXXXXX??XE??XM||XEXXX??|XXE?XXXXXXXXXXXXXXXXXX
