---oXo-?-B-E-----X-?--XXX--oM------EXX-M--X--oX?---MM-------o-----M--------B--E-o--X-MX-B--X?X-?--BX-----?---X-M-X--MBB-?---------M---?XEM---MEB--?-oX--M-?-?--M-----------E-E-?--MBX-X-M-M-MME---------
-X?M---o---M-E---M-EM--X--Mo----M-ME-------X--X-----------o----oE-B?---X--M-M------X-------E-X-?---M----?X----?----oX?---------------------MM--B-EBM---E--X------MM-----o---X-?------M-Xo--o--X--E-E----
---------??--o------X-BX--??----?X-M-M--------XX--o?--?-----o-----ME?M---B-E--M----X-X-X-M---M-o-------X------o---o-X-oXEXX-----o-X---X----B---E-XB--XX--E-XEX-XX-X---X--E-X-X----o----o--B----X?M-B----
----E----o----B-----X?-E-X-?-EBE-?--Mo--o-o------X-X-----BX--Bo-----E-?X-o--?--MXo-X-o---B-??----o---------oB-----B-B-X-X?--?-B-----XM--o--oEX?---------B----E----?X-M----?oXX---E-?o--X-EX-------------
--EBXB?--------XB-XM-?X--B------E-?-------X--X-XE-X---B-MM--EEX-EB-B-XX--o-o-XE-M--?X-B--X--?---MM----B-EE-----?--X?-M---E--M-?-----E-M---------E---E-o---M--E-X---?XX---M------BX-----MXM--o--M--MB----
--oo-----?E-BXBX----oEo--M-?-E--X?----o----?E--oM-M-o-----XE-?X-E-X-XEo-X--?--MM-X?-------X-E----?---EB----?B--X--X---E-EB-B---XM-o-X----XX---?-X-o-X-X--?X-X--X------X-?-oo-B---o-XX-M-M--X--oX------X-
------?-----oMXo---XX?-------o-o---E-o----M--??--XXME-?----B--------?B-XX----B--------M---B?o------M--?--oX---oX----?E-MB?-XE-X--o--------X----B--oBX-M-----MX-------XBX-o-M-X-E-MB----B---X--o---X-----
---X-E--EB---X--ME-----XM---o------X------M---B--?-BE---o-X---------XX-XEX-B---?B---?--M--E--XX---X--o--X---E----M---M--X--X-E-MX---------X-?----?MEE----M----XM-EBMX-M-?----X-X--E-----E-----X---o----v
--E-oM-----B--o-X---X-----?E-------?o--??o----X-E--o--X-X---?-oo--E-X-------MX-?o---M--X--??-X---XEM--M---------?M-EE--?-?---X?-Xo-----------BMXB---------M----X-B--------o--EXX---?----B-EX-o??-M--X--f
----o-X--M-oM----BX---XX?o---E--BB--o-oM------?---X--XX--o--?oXEBX-M--------B-XM-?B-----BEX---?----X------B-o-E--X-X--M------M-?E-X-E-B--o----M----------o-X--X--X-E--o-X--Xo---o?BX-X--M-----X--M-X---f
-?Eo-M-X-?-X--X--E-----EX----E?-Xo-o--?-o-o-?X--X--M-B-M--?-----XXB-?--B-EX--E---M------XMXM-------X??-----E------E--M-X--XoE----XE-o--------X?---XEXBX--MB----M?-X--------X---M---M-X--B-o----B--XX---f
-------?----------B---X-o----E?X--------o-X-E--EMB--E-E-o---EoX--XBB-X--M---E-?--BX--o----?XM---EM-ME---E-----B----BX-E---MB----X-----------B?---M---X----o--X-MEBB--M--X-B--oo---?--XXX------B-------of
-B-----M-XB--E-------E-X-BBo-------?---MX---X--E----?----ME---------X--?-----M-----X--?-E?o---M-o----??oM?-----?X-----o---MX---oB---BX---B----X-XX?E-X----oM---o--M-----o----E------o--M?EM-X---X?X---of
-o--o----XX-X-?--BM--XB---X---X---X-oM-X-----?-M---ooX-M?M-X---B------?-M-X---X-ME-B--B-X----X-X-X---B-?oB--E-------Mo--M-----o-M---M-XX--?-X-E?XE-B?--X-------XM-X--------B---?-EB-B?--o-?XX?--X-oB-XEf
m--M-MB----o-X--M?MXM-?---ME----E--B-E?-oX-ME---------oE--X--XX-MB-?-B--?X-X-----X-M-----?--E----X-----X-E-X-?----M-------X----B----X--E-BM--B----------B-------X---?--BX-Bo-Xo---XE------X--X---E-X---X
XXE---o----E--?---EoEB--X-?---o----E---Xo--E?-----X--?X--E------X-B-----X-X-----M---o--------?-------ME----?-X------o---?---X------M?-------XM--MX-------E-X-M----X-Xo-o--------BXX-?-------o----EXEB--X
