-----?------E------o---------------o-?-?---------M--?EB-----------X-?M----B--M----M----X-X-------X---M--X--Mo---o-o--oB-----E-M--?E-B----E-o-----E-o-----?-o-B-?----X----E-XE--------?oE---E----XM------
--X----M-EX-B---------M--X------M-XM-?---M-?---E--MoX-?-B-o-o----B---------?X-E--oEoBX----------M-------X--?--M?X-??----XE-------------?-M-----X--M-------o----E----?M--XM------BM-----M----B--o-E---o--
------B-------XM--X------B-M-?-o---M-X-----------E-------------XM----X-X-X--E-E-----EBX-MM-BM--o-M-----E-----------B--X-o?------M-E?--X-o-oM---o-?--?-----o----EM-?-----B--?---E---E------oE--MXX-?-?---
--Mo?--?M---X-X-?--X-XM-------?---X-?--XMMB----------E---------EMo-B-o?X---ME---B?M--XoB--X--?E-----M-M?B---M---B--------MoBX--oM------M---E--o-E-----------B--------o-Xo---M-X------------XX---?---EM--
--E---o-?-B---o?XM--B--M-EE?-X-Xo----M---o-M-----------MoE----E----BE---------XB-ME?-o-oo--o---?o-BX-Eo---MX----------B-B-----------E-------o----X--?------o-M---X--M--BE-?M-E---X--XM-E--M---M------MX-
-X-E------M-B--M-----BEM-B------oo---------B-XE---EoEME-----E-X-Mo--E-----MB-M------Xo-o---MB---E-?-BMEBMoMo--------M------------M---X--E--MB---------E-------o-oBXo---?MM---B-E-E--------------?--B----
-------M-----M--B------XMX----------E--E--MB--------------------M--o---XMo-B---B?-o?------E---B--X-oo-o-E--M-------?------M?------Bo---------------E--E-------------X------X-?----MX--M------M-----E-B--
--B--o-?---BEB--B--B----------M?----------B-o-XMo-B----B?B----X---B---?M---E------M--------B---M-B-X-------EXo-----------E--oXB----E---oMB-------E------?------?-?---X----BE-?-oM---------oB--------B--v
-B-?E---?--XM---?---?X?---E--B----MMB--?o--o-----?-----------B--o-X-Eo-----XBXo--oM-?----B--------B---XM---?X---?---M--XM----BBM---o----M-----Xo--E-oE---X----MX---------E----?-----X---M-E----------XEf
----E---?------M---X-o-E--o-----?o-M--M-------B---X----o--XE-----E-----oB---------o------M----B-?-??---X---E---?BB---?-B----?----?-----BM-----B--Bo----B-B-?--oE-M-------B---------?-X--?-E-B-M---M--M-f
---X----B----?-o---EE-------M-----E----B--------E---?Bo----M-o--E--B-M?E---o------?--MM--X--o---oE--B--E-------X---E-M---?X---M-?B--------M--------o-X---?Xo---B-----B??-B------------EBE--M-------?B--f
--B--B---X----BX--M-----B--X---XoE--------o---o---MB-o-XBM-o----o---?Bo?E---?o---------M-MoX-o-o--------oB--M--?-M-------?-----B-M-EM----------M--?-----B----E---MX?E-B---E-E-?----E-M-Eo-?-B---M-M-B--f
---B-X--BE-B-XM-?M------?-oE---o----------?---o--E---------B?--??---M---------M-B-BM--?-o----B-?-oE---B----------oo---BB--o-XoM?-?-B-o-?-X-Bo-MMX-------M------------?M-----M-B-----XBo?-------o-?B-M--f
---M-o-?---?oE--------X-------X-?---E--X---X--oX-----E?-------B-oB------------?E--E-X-XBX-?---M-X?---XMoE---E----E------------B-E-?--MoB---------Xo-------X?---X-----?---BX-X-----------M-E---B----XoMBf
m--B-E--------B-?---X-----------o-X---B--o-E----E---B----B--X?----B---B-----M--o-XE-E--E------E----oo-B------o---?-XE-o?---?XE--o------X--E---E-X-E---BE-o--oXEE?----M-------M-Bo---XM-B-?-------X-M-oEX
X---?-M-----------Mo---E-Eo-----M---?--E--X--EM-----M----M------M--B-B-B---X--X----X-Mo-?-XB--?-MoEB----X-?--M-XE---o-BE-----o-B----X--B---?---X-B---?-o-o--M--E-o---?BE-oo-------?M-------XEE---------X
