M--Eo-------------o-o-----------------XXoo-----X------o-o----------o--E-----o-----------X-E-------o-o--o----------E-----------o----------X---------E----o-----------o-------X-E------E--------------X--M
?---------o--o--X------------------E----X-------oo--X--X---o--------------------o----Xo---E----X----EE---------------E----X-o----X--------------------E-----X-------E-----E---------o-EoX-E-----------EM
o-----E---X-----------------------o-----------E---------X------XX----------EX----o-------E-E---E---------Xo-------E-----E-EE-------o---E----X------------oX--------o------X-X-o--EEo---------X--Xo---o-T
M--o-X-----X---o-----------E----XE-------------X--------Eo---------X-------------E---E---------E--EX-X---------o----o-------------------------------------E--E-E---------------X--X----o----------X--o-o
M--E-E--EEX----E-o----o--------E-----X-----------X--------XXo--oo-X----oX-o---------E----o------------------EX---E-X----E-----------o--------------------XX------E--E--E-o----E--------EE----EE--------o
XE--X-------------------X--X--o----Eo--oX-----o----o------------------------E-E----X--o---X-o--------X------o---X------------------XE----EX-------oo-o------o----------------X-----oo-------o-E------X--
E-----o-----EoX--E-o---------X-E--------E-----EE--X------Eo---------oo--------E-X---------X----EEX----E-E--------------X----------E----------o-E--------X-EX---------------X--X-----------E-X-o-----X-oM
X----E-X---------E--oX--------------X------------X-E------X-E------X----E--------E--Xo-E----E--X-----o-X--X----X----------o---------X--------------oX---------Eo--E---X----o-------X----XoEXo-E--------v
E-B-??--E-----?EE--?M-M?E--E--?-M-X-o-?--X--X---oB----M----M-----X--------B---o-------M----M---X-o--X-----X-M-B--B---EEE-XX-------M?XXMM----X----o--o-----o?M--------BE--B--------?---E-X-E-E-----B-----
X?---o-----E-----B----E----?--?--BB-o-----X--M-o--E----X--E------------X-------M------E---B-------?---EEX-M---------M--?---BE--------------B-E-M-Eo--X---MM---M---oM----------X-?-M----B------BB---?--XX
E-?---o--------------MB-E------o----M?--------?-o-----o---------X---------o--E------E----o----M---oBE-B-M-o-o-o------B-?-E-------?B-------------o------------X--E----------M---o---E--M--B---M---------?
---?---o-E------B-----E--M-------M---?-E----XoX-X----M----?E--------?--ooM?--M--?XM--BM?----M-EE--X--E-------B--?--B-X----------M--o------EM--o-?MX-ME------o-B---oMB-X-o-E--o-M-----------M-?----BX-?-o
|?M---E----?----XoB---MMX-Xo?------?--?-----------M--oo---oo------??M----E-----B---?B----------M-MX----MX-----?-X---B--M--?E-oE--X---?-X---?----BM----Eo?----X-B---?--o------M---o--o---B--------E----B-
o--M??--X--E--X---B----o-------B----?------------E--E----XE-EEEM-B---EXMo--B-----E-?-E---o---M--B-E--X-----B---E---X-o--oB?---?--------?o-----X-----E----XMMo---?---EEX?X--oB---o-----XB-?----MBo--E----
m--X---X-------?E---E-E---oo--B---BoB---o--B-o-XX-----------?---XM--M-----?---------M-o-------MB-o?-------BM--B--------B--E-?---o----M---------M-?--------M-M--XX------o-o-----B?-B-----o--?--o--------M
XXXXX?XXXBXEXEXooXoXXX?XXXX?oXBX?XXXEXEX?XXXXXXXXB?XEXMEXXXXEXXXXXoXXoXXXXXXXXXXXXXXXXXXXXMXXXBX??XXXXXXXXoXXXEXXXXXXXXBXXXXXXXXX?X?XXXXXXX?XX?ME?XooXXBoXXXEXXXXXXBXXXXXBEXXXBXXEXEB?BXXXoEXoXXXoE?XXoX
