-XXE-EEX-XX----EE-B-E-Xo-?-XBXXXM---E-EXXME?XXBE--E--M-X-oEE--oEoBB-Eoo-XEEB-EE-E?E---B-B-XE-MXME?BXEXBXX-BEB?EMXX-MXE---o---MM-EX?X---EM-oE---XEMEX?XoXoEBE-XXME-E?MB-BBEEXo-E-EEB?E-EEXXE-?X--MX?XE-X-
-XB-B--XEXM?-XXoBEMB-MME-BoBMoXo-oE-Bo-X--ooXEEM-B?EXX-XX-oX-EX-o?-E-X--EEMBX--E-E-EEB-oBEEBM?--?E-E-oB-oXE----o-E?-XX-EXX-X?XME--M----BEE?-o---BX?--Xo-X-XBoE?-EE-Eo-?-ME--B-XX-E?-X-E-E-EB-XM-XE-oXBX-
-Xoo-EEXEEBXoBEBE-o--oE--o-E-EXME--XBEEEEE-EXXEXE--o-XXXE-B??XMEX-XBX-E-Xo?----oM-B-EXoEX-XEoE-XB-MEE?Eo-oEE--EM---EB?o-EB-XX--XBEEEEoEXEE--?EXo-E-o--o-XXEBMXXoX-oX-BMBXX-o-X-E?E--EoM-XEXXEXEE-B-?E---
-BEX-----?X---EE--E--E-Eoo-XBXB-BMXMXEE---XoX-E--?-EoBE?--B-XXXEXBEX-?X?-B?XXXX---?-EXX--?-XB--ME-EEXX-EEXX-E-E-X-?X-EBEBooE?-E--o-B-X-ME-EX-EoXXXM-EEEM-o???X-MXE--E-XBXB-XM-E-oXBE-E-oE--EXE-BB--M?E--
-o?o--B--oB-BXoX---XMooXXo-XEEMXE-XEBEoE?BXBEo-?EE-E--BoBE-X-XEE--BX--XE-EoB--XX-oE-XEXBEE--EXEXX-EME-EM?EM--o---EBX?-XEBXEXX-MoE-X?E---EB?-EX-o?B?EBMEME-oX-X--Eo-XB-XM-oMoBX-XX-E?--X?-XXEXo-----EEXB-
--E-oX-B-MMEo--o-EMXE--Xo-oXXX-oEoXXB-ME-XX-BEX-o-EB-o?XooXMBo?o?B-EE-XB--EBE--ME-BE-XBX-oEEE---X-o-BX--BoB-E-E-X-X-E-MB-oX---B-E-EMB-?-MEMXE-EB--X-o?M---EXXooEEX-EX-BE-?-E?XXX-?XB--B-M--XEM-XEEX-BXB-
-X?oXXBXXBXX-BEBX-Eo-?X-XE-X-------EXoXEMoBE-BEEEB-?ME-E-XBXE--EEXE-M-MBo-?EEEX-XX-?oX-EX-M-Bo---oEXB-E?-XX-MEEB-M--M--EXooEoBoXM-EXXXEXo-X---?-o-E-EEX-?XEXXE-BB--oB-MMoXMEo--E-?E-XM--BXXXBo?ooE--XXB-
-oEEE--BXB?EEoM-XE?EEMXXEXoo-B---E--?BEB-XBE-X-XXE--Xo?XXXoEXX-X--BXoMEEE-B-----E---MoX-oMoXE?XM-XBE--ooMEBo-o?-E?BoEM-oXE-XE----E--E--X-o-EBB--X--XEXE-EBE-X?XBBE?XBEXBo-o---EB-B-EoE---o--X?EX-E?-??ov
-XoX-XEE-B-E-X-X-E-E-XXX---XXo-XX--MEXEXXoEEEo---?-oo-E-XE---B--MEEX-BooEME?o-XX-EXEB-E-E-M?o-EoXB--XXMXM?-XXXEXXXXo-XE?EM--EX--EXE-?BB---EoE--XB?oB---oEE--XoXBoBXX---?EE?EXo-B-XXE-BXX--B?o-M-EXMXEXMf
--E-X--BMMXXX----ooEB-o-Bo---?B------BEo-BEoE-E--MXX-XEEoXEX--EE----X?X---XEXXo-E-E-X-o----M--oMoEBoEBM-M-B---XEEEXM-X-?MMEEXEXE--E-BXX?EXBo-XEB?-E--o-B--B-o-EXE?MX--Eo-Bo---EM?-EBE--Xo----?EX----XXEf
--M---XBE--MMX-B--?EXBX-----BB?oX-E-oXB--o?oEBEB-B--BMEBEoE-?E--EXEX-BBo-E-B-B-oE--MMo---EB-M?E-E-BX-E-E-XBEEE-BE-EEXEXE-EEBE-X-XB-E---EoBXX-X-EB--o-EBXBEMB?-oXE-MMX--XX---EEE--BBB-EEBEX-EE-?Xo-EBX-?f
--XBEB-M-B-XME--EBBoX?Bo-E-MXXE-???oM--oEBBE--E--BMo--?Eo--XBXEEEo--XX-ooo--oBX-EEB-EXoo?E-M---Xo----XEX?-?--X-XXBX--oXEEB?-EB-XB-----EX-EMoXX?-?XXEBX?XE--XEE--B?X-BX-oEoEE-----oX-?BXo-M-?EEM--BEXoo-f
---EBoMoX?o---EMB-M----MM-XXM--BEB--XEXB?-XX-E-XXXE?BXoMXX--oEXEMMoEoXE-BX--MMXEo-oEX-ooE-oEE--BE-EBoX--Eo?XB?BXM-M-X-EoM?BE-Xo?-X-XB-?M-EE-BX-XX-XE--Xo?-EoE-M-EXo--XMXEoBX?M-?BEX-MX--X?-B?B-XB-??EX-f
-E-ME-X-XX--X-E-XoEBXX-?---XEEB-XX-X---X--oB-B-o-XX-BEoX?---oooBXXEE--BMXBBEX-EXEEXXo---X-o--XXBE-X-E?-MEE-X--MXoB-XM-?X-B-E-E-EBXE-XBXX--X-?X?XEX??-XB--oXX-EX--MoEX-Xo---oo--?BEMEoE?M--EE-Eo-MX-XX?Ef
mXE?-XEBBX-E--E?X-EMEEXo-E-MBB-M-BBE-EEo-MXBX-EoE?X-XMBE-EXXo--E-B--XE-E-E-XEXXEXoX-X-MXXX-Bo-oMo-BBEEE-o-XEXEBMXX--B-?-X?EEEEBXXB-B---EXX-----B-MoEoEE-BEoX-BMEXEo-B---EB--X-XXEo-EX--oB-B?oBX-XX-X-oBX
XE?-oE-M-EE--M-E-E-X-XE--BE-EBE-Xo-MEX-XE-EEXoXB-----X??M-oXX-X-o-X?X?XXXXoEBEMBEE--X--?-XX-XE---X--MBBXXXE--EXE-B-B-M-XXBE?o?--XE-?EEE-B-E-?-?EB-oX?XXMEE-oX-M--?XEo-oo-?--oXoEX-oEBXEE?-XX-MXEBXX-X--X
