-XEX-X-o--E--XEM--B-X-XEMEX-MXM-X-oXoX-EE-M--MX-BXBX-EBXMEB-EEEB--XEXX-X--X??oXE?EoEoMEXM-EX-EXE-E-XEoEXB-EXXX-XEE-BEE-XEMoX?--XBX--XXMoXBBEX---M--EXXE--MEE--XX-XBX-EEXBEX---XEXoB?--BMEB-XoE-BX----XX-
-EEXEoM-XEoXB--Mo??o--X-B--X--oXXE----XXB--XE----XEo-EEX?XXE-EB---X--B--oBE-XE?BX-EBXEXXX----B-o---oEB--BMoXo--BEE--EE---oo-X-o--?-M?---MX---X-E--B?--MXoEE-EX--oEE-B-?-E?EEXXXXBX--B-X-?EE-MM-E--XB-?X-
-MEXEMoMXXoXoBX-EBXEEBoBBM-MEX?---XXX-ooo?B-oE--XB-XMX-BX-E-BXooX-B-MBE--X-EX-BoX----XX?XEX-X-X-B-EEXX-X--EM?B-Xo-E-?EX-BEE-M-?oXXEM--EXMXE-X-EEX?XX--E-EM?ME-?MEX?-X-B?XE-XXX-EoEBXX?BX-MMXo-X---oXX-E-
--EoEo-ooMXE?B--EBX--?-?-XoEEEXM-Xo--oXBMoX?--B-XXB-oM???-BX-EEXBo-XXE-M-E-X?XE?-BXEBEX?EXBBoX--EEBXM-E?oMM-BXMBo--EB-M-E--M-E-?E-XXEX-EoBEEE?-EEoEoXooXXEo-MBX-oM--EE-Xo-o---B-EBEB-B--oE----o--BXMX-B-
-XXX-XoBEXXEB-EXEXXE--XX-o?-X--EE?BX--o-X-XEXX-B?M-XB-B?-EEXB-B-XoEE---M-BB-EoBE-oXEEX-Eo-BoEMX-EX-XoXo-oXE?--EEEXX-EE-E-o?B-XE-E--o?B-Xo-X-M?EBBXEBXXXEEXBE?XXB?E-BE-EB--XB-o----E-EXEX--oMEo-M?E?X-X?-
-EX--X--XEoXooEEo-oEXXB-?----MEE-B-oBBoo--XMX--B--BEXE--X--XBEXXoM-X--B-XE-oo-BB-EX---XE--MB-?-XoXM--EB-EXEooBXo--XXoEE-B-o-XEX-XEEMEoo-BE------XXE-oX-XX-o---MXX---EXBEEBX?--E---EXXXE-XXoX-XX?X-X-XE--
-XXXXE--EXX-BEXBX----oE-EBXBEoEMX-XXXEEEo?-ME??---XME-B-EXEE-E-BE-Xo?-XX?-X?EXX?EEBE-X-B?BBoEB--EE----E-?-?-oooX-MXE-X--E---XEX-X-X-B-E-XMBo-?o-X-M-X--X---XEEXMXEMo-XXMXEX-MEEEBB-oEEXX?X-XX-XEB-EXEoo-
-o??X-MXEEEX-X-XBEXo?-oE-EM-EXoEBEoBoX?-BBX-XEXX---EB?MXo---oMX?-EMXXX-E-X-BX-E-EEXEXMBBBoE-EE-X--?-BXEEB-?XEXB-EEMoXE?o-EEE-XEX-?-ooBX-EoE--BB--oEooBoEB-oE--?--MX-XBEX-X-EE?X---EXEEoo-BoX-X-oBX-EE-Xv
-XBX--ooXXXo-XBB---X-EM-?--?BX-MXM--XEoE--EX--?B-XB-?-?BM-ooXXMX?EX-X--XB-o-oBXooBEEXEXoX-XE---?MEXX--?-E-oEE-EXBXEoEB-XMBo--X-X-BEoEE--X-E-XXBo-BBB?-XXXX-oEXBEoBXEEo-XBEEM-E---o?-EEXMEXB--X?-E-XBX--f
-EB?EB-o-E-XEXB--EB--X-B-?--BBXXE------X-EBX--XM--BB-EM?-B-?-XX--EXBoXX---MBEX-XEX-XE--X?oo-MXX-XXMBM-BE-XMB-BXXM--X-E-B--XEoX-o--X-EM--o-?-oXE-oo---B-EEE--EEX--X?M-X--MEBX-X--XE?-E-oMX--oME?-BXEXEXEf
--EBXM-XEXoBBBXBXo-E--XM-E-X-MoE--E-X-BXEMEXMEoBooE-E-MoXBE---X?-oEE-EEE-XX-X??XM----E---X--B?-XE---X?EBX?o?-E-E---o-EEEX-EoX-XoBEX-EB-E?EX-?BXEEXXoXE-B-oBX-E---o---XXE-o-B--X-?XB-EXEE---o--?-X-EXXoBf
-E--EB-EEEEX-E----XB-EXXXXX-X-?-EXEE?--XXEo-BEBME-o-B--E--?EEB?EEoBoE-BXEo-EX-ME-o---XB--o-E--XXE---E?EEEEXo?XX--oBB-oX-E-EEXXBXXXX-BXBBo-oXoE-ooEoEo-EBXE?oXEXBBX-XB?M?-X?EX?B-X-X?BE-?EXMEX-EMEXo--oEf
-MX-BE--XoXEXXX?--X---oX-E-oX-o?E--Xo?EEoEEE-EMXM?-XMEEXEEXoX?ME---XE?E-B-XMMXEBXEB-E-EM-X-oX--EXBXE-oB-XX---EBoMBEEoE?BoX-oXB-BBEEMXXEBX--?-XXE--MEE-E-E-EEM?--BE-E?--Xo?-oMXE-ME--MMEEBEX-XXB--XBBXE-f
-----XX-?X--X-Eo-X-o-XEB-EoX---EM-XE-?XE?BEo-X--o-EMooM-E-X--XX-X-X-B-E--B-?EXXEB-?EE?Bo-o--?E--B-X-o-E--B??E?X--B-XEEEM-EoX-X---EM-BEXEB-oX-BM-XXoEBEB?o-oM-XX-XXXEoX-EBE-o?X-?BXBEE--E-EEEXoE----XXEEf
m--?XX----X?----ooX--E-XX---o-oB?E-?B-E?X-X-o-E-MXME?Eo-?M-X-B--Xo-?XXE--EoBXE--X?B-oo--XBXMB-EXMooE--E-EX-EoEEX--EE-E-oXX---MXXEX-Eo---E-oXMBEoEBooXX?-----X-EEXE-EoEBoB?---ooXE---MX-E-XEEEEEEBo-E-EEX
XEXoE-Xo-XMXMX-E---EEX-EEMM-ME-?XMM-XEoBX-XX-EXE--X-XBEo-XoE-EXMoXX??X-o?Mo-EEoXEEEoM-B--X?EBEBE?EBEE-XX-B--BXEXXoMXE--o---X-X--EBo-XXB-ooXE-M--XEE-EXMB--X?--Xo-oE---X-MooEMB--oX---?XMoo-E-o---XXE-oEX
