T---?---M---MM?--X--------BM-o---E-ME--B-E--?oE-E-X-M------E--------B------E---EoB-?-?--?B---B?--M------E---?---BXMoo-M--?E-X----M-E-------E--E-o-M-----?---X--?-B--o--M-X-o?----------EX-?----M?B----XE
BB-E-----E----BE---EXB---E-----?------?-?oMB---E?----o-M----E--B---?-----o--?----??--ME--B----o-X?--------XM-?----------?-?-----------X?X----M?-??-M--XX-------M-E--E-----M---o---------B----B-?o-------
oM-----E--E-------M---o-----?-X-B--X--?---MEX?--XE--EBoMXB--Bo----BM?---M--X-o-E---?-o---o?-M-o?---E-----?---M----M--X--?------X----BB?--X-o-------------------?M---X-?X---oE--------B-------E-M-B--M--o
B?----X-M---Mo--M--E-M--------Mo?---X--------E---?X---o-M-B-----?----M-X------X-?---M-X-----------M-E---Bo--oXX-EX---Mo-E--X--X-----X---ME-X--B--M-----?-?------M--E--E-------o?M---o--M--B-BM-----B?-BE
|---------B-----o---M----o---XB---B------------X----XXB--B-E----E---M--BM--EB----?-------------X----MX-----M??-BX-------Xo-----o?-M----X-B-----XMEX-?oX-Mo-?o-?--M--------o---B------E-oX-o-B------o---T
?E---X---------Eo--?---oo-X----M------BBo-X---------Mo---BM---?---o---BB----o---?X----o-B-----X-------E--B-----E-?--------E---BEX---?XE--X-----B-oE?---X-----?----B--M---?-M---------?-Xo------------E-|
TXM-B--o---oM---BX----ooB-----X---M--o--?B--MEo----?---B--Mo-----X--o-??-X-?M--EB-------B-E---M--o----M--------B--X--E-?--------?-?------E-B----------E-o------BE--------oBo---?-B-E--X-MMoX----o---X-oT
BoE------oX----o-----B-MX-E-----?------E-E---------------E----o----------M-?-EMBM----M----E-----B-E----B-------o------M--M-E-----B-X--X-E---E--M-M---?-o?--?----?-o--o---------E----------MX----B-?E?--v
?--MXX-?-?-----B-----EoM?--E---BEoB----------M-M-E--------X-oX--?-?BX---o---M-----E--B------M---?-XME---E---o-?E-E-X--M--B--EE-?-B-X-M---oXE-oE--------M-M-----E---EE------------BE--E--MM----B----XE?--
o---Mo--EXMMB-E----XM--E--B----X-------?-B--o?----oM---------------M-----------E-----E--------X----X--o?--B---M--o-o---MB-X-MX-E-----B--M------E--B-------------oM-MBX------oM---o---?-----X--o--------|
|-o--BXM-----BX-----?--------------Bo---X--BooB--E---X------oB-Eo--------o----------------?-?--o?M---X--??---oX-----E--------MX-X---EB-E--------XB-BM---X--X-----------B?------------E----XX--o--X-B-M--
|E-B-----B-B----M---o----BBM?--Bo---E-M---E------X?------?--M-------B-o----oBB-?-----B----?-------?---EX-M----o-----------------MX---B-------B-B---B??-?X--M--MM--E-X-EXX-------------o------M--X-----o|
M---oo----E-E----B-E----o---M----MX-M----B-----------M---E-------------M-?-o---E-?--X--oB---B-B---E--X--B-?----?---?--M--M-B----M?--------?--o----M--X-M---------------MM----E-M?-o---EX?--M--?---o--?-T
T-X-o-------E-----M----o-X----X?B-M---?------M----M---------?-M-B------XM---XM------------E-X-------o----o------MMo--o---E----------------B-X-o---?M-----------X------E----M-?---EX--?-o---M---?-o-M---|
m----------M-----?-----EEXB--EBE-M------B---X--------M-M-E---?-----B---M-o---X-------M-------------?-?-MoXE-B----o-----------B-----E--oo--X-X--?Xo-X-B----ME-------E-ME---------X??--E-----M--E--?-----M
XXXXEXXEXXXXXEXMoXXEXXXXXBXXBXXXBXXXXXBXXXXXXXXXXXXXXXXXXXXXXXXXoXMXEXXXEEMXXXXMEXXX?XXXXXXXMXBXEXXXXX?XXXXMXXXXMXXXXXXooXXXoXXXXXXXXXXEMXBXXXEEXXXBMXXXXXXXXXXXXXXXXXXEXXXXBBEXXXXXBXXEX?XBXXXoXXoXXXoX
