--X---M---o-----EM-------M---o--------EM---o------?-o---------X--BM--------B--?---X----B?-XB-X?--B--M----?----?---EM-------oEE-oX--------X-X-?---E---M-M----X------?--o-o--M-------B---------X--M-E-M---
-o----EE-X-M-E?X--------oX?--BBX-B----M-E?M-------M--o--B---M----Xo-X-----E-o--BE----E?-MBo--B--E-X---EX--?o-Bo---??---B-o----------XXE-B?--??E----X-EB--X-?---?------B-----o-EEB-----EBBMoE--E?--------
-----M-o?B---E--X?-o----B-o------------E---B---EM--M--?-E----oM----XBo------?E------o------?BX--X---o-----EMB-Mo---E-?--X----------o-M-oB-B----X--o---------o-EB??--M-------X--MXM--B--B-M-----------EX-
----E---XB--X----X----?M-----M--E-------E-------?-MM--X--o-B-?-----B-----M--XM---------X---X---------X-----?--o-------M?-E-B-----M?M--o-B-MX--o--o----X---X-EX-?----?---X---XM-X----M--B---B----o--?----
-------oM-?------E----XM?--------?M-----X----Mo--B-E--?-------M-B-o-?X-X--?E-M--E-MM----EM-------M--E---XE---?---B--BX----oE----X-B-EE-B--?X?X-E?---o-EXB---o--BE--X--XX----?---BM-----M--M---B-----Mo--
-X-?---------o---------M----o--------X---X--o----X-----B--M-----o-M-------?--X?X---------X-B?-?-?-?--B?-----o-----B---Eo------B---B?B-E--M-B--B--X-?E---BXo-----?-oBB--XX--------o---------X-M--Xo??-?--
-B---XXX------M--M-MBM--E--M----------?--E-B--EX-??-?Bo--XX--X-X--Bo--M---------------Mo-E?------o--XBM-XE-EX-BM-o--X?----?-------X?-M-E------?--X------BM---X--?------M-----Mo-----E---M---B---E-?--B--
----?------X---------------E-----BM--X------B----o-M-?X----M----oX-----B-----B--E----B--BB---------?X-------M?--X--BB----B-----------?-X---o-o-----------?------oEo-------E----E-------?----Bo----E---Xv
-M----X-------o?E--B-E--o-E-----X------?-----?Mo--?--B-o?-o---X-E--E-B-E--ME---M---B--EE--oB----X---o-?oE--MB---X-?-X-MMo-X-M---M-?-?M?-X--M------o-X?--B---o-B----BXBE-B----M-M---?---X-B-XMBM--------f
---?-M----o-o--B-------X---M--oB-B--?------MBM---o--oE---X-M--X--------X-B-------Eo--EE--X---BMo---M------B-E---------E------?B---E---E-----BB----X-X----o--?X----o----o-BBE-----B--------E?B-oM------Xf
-oX-----B-----o--M--?-?----B--X-o---BE--BB?E-o-------o-E--?E---o-B-M?-M--------------E-M--M-----o--------o-E--M----X--X---BX-------B-----MXB--o-E-XX------B-?--Boo-------M---?---B--M----o-M---o--E----f
-B---o--M-M----B--o---------M----EB---o---MM--------o------o---o-----------?--------?o--XBEM--o----?--------o---E-o----E--------B??E---EE-E----X-?o---------E?----o---X--E---?--------M----?--BX---M---f
---------MX----?--E?--X--------------o-X?-X--------------------?oo--E-----E-E--X-?-----M-E-BM--X--X--E---o--o-o-M--X--M-?B-?---M-XE---MB-------------MX---?---o-E-B-----E---MX---------X--XX--E-X--XM--f
--o-?E--?---oX--E--------------------M---X---------?-?MM----EM-Bo---B?-o----oM-B-BE--E--Eo?--B-M---X-?-EB--Bo--B-?--o-----E------E--M---o-E-o----M--E-------B------EX--?E--X?-?---BE--BEo----?---XB--XBf
m--------?-B--oB-?BoM--XX--oEo--X-X------?-------X--------M--o--B----M----oBX----BB--o------M----M---E--B--M-------MX-o?-o--o-o?---M--?--o--M------B---?-X--BooX-B----Mo-Mo------M-?--------X--o-------X
X---Bo-E---------?-B----M--o----M--M--EE---MX-?--------B--E-------E?X-----?--X-X--o-B------o-------?-----X------EM------o-M-M---X---o--E-o--o-E?----X-----M?------?-----M-M-BB?-?--------B--o-EB-X--M--X
