XXE?--B----B---X---o--XX--o----X--?------E-----E---B-------E?MBoM-----B----------E---?------B--------B-X-----XX-----M?----------B-M--?-X--E--X-----E------ME--?--X-MoXE-----E-M-?---E---o?M-?E-M----B--T
-oX----BX?-----X---M-o?-E?X----M?-X--E----X--M?--?------?B-oM--X-EX-------E---o-o-MMM--o------XB---EBBX?-----------E--E---X-?----oB----X-----------?--------MoE--M--------o-o?--------M---B-------X--oM-
E?-o---X--MBXM-------oB-?------B--M--X-M-------------??-o-------X------oX----M?----?--oX-B--E---E----------X-M---M----E-?X-B---?-EX--M----B-M----o-EE?X-------ME-----E----E-----B----B---?M--X--B--Xo-X?
|--X--E----B---MM----MB--o----EM--X--?----?--B----M----?Eo?---------?-----E--EX--E?-M-X-E--E--B---BMo---MB----------------------B?--B------B---BB-------B-X-E-o--E?---?---E---E-o-EB--M-?E--B-X-?-M----E
X----X-M----E-----B-M--?EE--B--------E-X--Mo-X---M-----------M---M----M-o--B-Mo----oE-EM?--?--EM---------?--?-o-o--EE-MMo-E-EB?--M--?--------E-B--??B-o----X?-X-B--------Eo-E-E-M--B-B--E---o----B-B---o
M--M-----M--?-oX------B?-o---E--B------X---M----------------o--BM-?-M-M----M-o?-----o-E----o-E----E------------o---?B---o??-------X--XM----EoM---------------EEE-----M-------MBX----X--?E---M-----?----B
X-?B-o-----oX------MXM-----------B-MB--B----B-E--Xo------MM--E----??E--M--E?--XX---E--B-----MEX--M--?-M-EMX----B-M----ME--------MBEE---M-------M--Xo---M-E-o-M-------oE---X--B---E-X---------M---M----EB
---o-MXEMX----?---------BB----MB---o-o--B-??-------ME--E----?--Bo--M-E--B--M----M-------BX--o?-?o-----?B--oo-X-o-?------X-E---X--M------B----X--EMB---M-----------------M-M----?-o--X---B--?--o-B--o---v
X--EBX--M---X----E---XE-X-----Xo---E--B--E-?-----B----ME---o---o-M------E--?o--XX--E--?-----B?-oX---E---------------M--MM--oXo--X-E--o-B--?B--B----?XE-------B--M----?X-B--M-XX---M------ooE-E?--?-B-o-o
o------------?-MXM-?E-MM-----?---oM---BoXX-----?M---X--M--BX-ME--XB--oX--XX-----EM-------E--BE-X-B-E-E-?---o?--?----B-o----BE----B-B------EX-BE----E---X---X---M--Xo-B--X---E----E-------M----X---?-M--M
o--BE--o-E--M-----------B?---Eo---------B-M-X-?Mo--o----o-o-X----X----------o--BM--B------o--?--o-------X?-X--o---B--o--XM------o-E-?-------M-X---X-o-----?E------M--BoXo------BM---o--oo----Mo------MXo
---------o--B-oB--B-E-------B---o-------EoX---X---ooE----X--M--MoM------?---oB----MEo--B--M-----M------E-MX----X--E----B-----?oX--M------XB-------X-----M--B--B----M--MEX-----o----o--?---X--------B--BT
T-B--E-----------oB--?---B?MXM---?--BM-o------------?------------?---E-MM------------------E-----o---o-----------B---B------M----?o-X-?XB--o-?-EE-B---B----X--B------B-X--EME-----E---Xo------B-----X--o
|----?o---X-----Bo?-E---E-oEMM-----?------E-o--?M--------B---BBo--Xo-----o--X-B-oBM---o---?------------BBo----X-?--B--?--?---B--------------M--?-------?----X-MB---X---?o-------B-?-------?M----ooE-----
mB-Xo-B-E---Eo-----B--M---MM---MXBX-M--E----o-MMB--B-B-B---X-MX----EEEXBX--oM----B----EE-E---?-X----------MX---M---?M----E-----B----X-----XM?-B-X--ME---?MB----E--X---?M-----??--?-----o-----?---BX----|
XX?XEXXoEXXXXXXXX?XXXXXXXXX?EXXBXXXXXXMXXXXMMXEXXXXoXXXX?XXXXMoXXXXXXXXXXXXXXXXXEEXXBMEXXXXXXXXXBXX??X??XX?XXXXXXXEEBXMXXXoXXXXXXXXXEXXXXoXXMBoXXMXBXMXXXXXXXXXXXXB?XX?BXXXXXXXMEXXXMXoXXXXXEXXXoXXoMXXX
