-B--X----?--------B-X--o--?-X---Bo---X----M-B-?o--M--o----o-B------?-E-?-EB------XE---------M----M---------M---o-?----B----?--B----X-?--X----E--B--o?---oX---o--EBo-E-XXM-M-M-----ME--oE--MME---E-X-----
---------ME--oE-----X----------XE---M-ME----X-BE-E----E---M-----M-X----M-E--X--BM--EX?----?E?-------o---MEM------Xo-----??BB---E--Boo---BE-M--B---------------o--o-----o----M??-EE----E-?----M-?-X-o-M--
--BX---BMB----M?MMo--EB------E-M-----?-B--BoB----o?-?--o---X?M---B---BB--------o--B--oB--XE----MX---?X--E----M---B-?X----------------?ME----B-----BXB-----E---E-M-o--M---M--MM-BE-B--o--XM-M---E--o-----
--XBo---B-----------X------------B-o-----B---------?-Eo-?--B---E--M--XE---E----?-E-----X------------B-M----o--B-M----M-X-B---M--------oX--X-----o--------M-M----M-----E----X-----E--E?-------??---oE?---
-E--------?---X-----XM----X----?--B--?B----------M----o--o-----?----M-?B---MB--?-o-Xo-----X-------------M---B?-B----------EE--X--XM--B-BX-----------?X------MB---MX-----B--B--------E--X-----M---?---Mo-
-?-----ME--?ME--XM-----oE-X---oBM----------EXX--B-X---M---E----M----B-------o?---------?-oX-X---M----B--EE------EE-o---?--EX--M--E----?o-X--B--E?Xo--EXE-------EXM-?-E-----M--------X--BB-BM?M-?----?---
-Bo--X---o--X----?E--------?-o-XM?Xo?----M--E-X-----B--?----o--MMX------B--E-----------------o--??M-----?-----M--E----------?--------M-----M?-?B-----M----?-----------XX-----o-o-----?-?----?------M--X-
-E---?-B---o--E-----E----B-E------E------M---B----MB-o----E?---BE-Bo----XM-M-o-M--M--X--?M-E-----B-----E---?X-----BB-EE--------oBB------B----E----BB-B---MM-?-M-------M------?-?----M-MM-B----Bo-----Eov
---E--oB-----?--o-----oB---E------X-BM--Mo-E-?-E-?--EB--E-MM-------E--------B----?-EEX---?---------X-M---oB-B-o--B-------?---ME-XX?----E--M-----BX----E-B-?-----------E-----E-X-MM--M-?---o---E--------f
-?o?--?------o----X--------BE?---M?X-o----------X-M----?-X--?---------E?-------o-----BM--M----Xo---o-?----------?---M-XMoE----?-----o---o-M-oo-M--M----B-oE--?--EX----E--o-B--BX---XX----E--BE---oXM---f
-E--X--o--M---MM----M-?EME-----o------E--E?--M--BE--E?----------B--E--B-o-X--M----B----B-o---------?B-B--M----o-B----X--XE-oX-X--?-M---E---o---B---E------B--?---oB----BME---o?----B-?M------M--?--M---f
-----MB-o--E?-----o---E-----o---?o----?---E-XoM-----MB-E-M-------B---X---oE--E----?---o-?-BX?-M---??-M-??-----BM--B--o---------?----oX-EoXo-?E--EB-------ME---B--?-----o-M------X------o?--?---?----X-?f
-X---oM---MEB--?---o---M--?--o-o----o-X-----------oXE-?-----B----E-E-----X--B-E--ME----X-M?---BMB?---Eo-X---E-----o?---B--XB-------MM--M-------E----o--XoE-XE-----EB--M?-------??B?-----E-B----?-?B----f
---?-----Xo?-M--EBX---B-X---X--X-----------o--M-E-?--?BE?---------------E--M---?-----?-MME--?---------oX---Bo-?--------X-X--Eo---XE-MM------E-o-----M---o----E--o----M-o-?-o--oX------------X-X-B-----Bf
m-o--B----M----------E-X--B---o---o-----M---E---------X-BM---X--M-------o---?M--B----M-B-B?B---E-----M--MM--B---o-E--M-?---E?-----B-BX-?----?----M---M----------------o-?--X---EB-B---EB--B-oM-M?-E-EMMX
XXMXXXXXEBooXXEoXXXXXoXBXXXXXXXXXMXXXXoXX?XXEXXXXXXXXBXXBXXXXXXXXBXXXX?XXXXX?MXXXEXBXXMXXEXXoXXXXXX?oXXXXXoBXEX?XXXXXXXXXXXXXXXXXXBXXXoXEXXEXMXMXXXXEoXB?XXXXXXXB?XXXMXXXXXXooEXXXXXoXXXXX?XXXXXEXXXoXXX
