--------------------------------------------------------------------------------------------------------------------------------------------------------------------------------------------------------
--------------------------------------------------------------------------------------------------------------------------------------------------------------------------------------------------------
--------------------------------------------------------------------------------------------------------------------------------------------------------------------------------------------------------
--------------------------------------------------------------------------------------------------------------------------------------------------------------------------------------------------------
--------------------------------------------------------------------------------------------------------------------------------------------------------------------------------------------------------
--------------------------------------------------------------------------------------------------------------------------------------------------------------------------------------------------------
--------------------------------------------------------------------------------------------------------------------------------------------------------------------------------------------------------
-------------------------------------------------------------------------------------------------------------------------------------------------------------------------------------------------------v
-----B---------------BB-------o-Mo---?----X?EXXo------o-o-o------MMo---X------o--B-B-----X----------X----------------oX---X-----BM-----M---B-----------E---B------M----?-?-o--M-----o---------o-E-M----f
---M-------------MM?o-X---------------M-E----M---X----X-?----B?------B--?-------B------o?-?-BE-E----EB------o---oE?-------M----?-----B---M--------B-EX-----E----E----X--B--M-Bo?o-??ME-------o-XE-EEo--f
-B--E-------BM-E-X-XE-?--?------B?-B-----?o-?-------E-X-----E?o-M--?BX--E--M-?---X-E-X--????---XE----o-E--o-X--?M--------X------oo---E---X------X-------MBE-----E-------?--oXXB-----o----------?--o-B--f
-M--M--------o?------------B-o-E---X-EE-oM--B-B---?--M--E-----?--oMoM---------E-E--------------oMEM----E------B--B----o-?M--M?-B-X-------?X-M-----E-------BE-M---E---Xo-B-oo----?E--?---B------?--?--oEf
-----EXMB---M----?------?---E--?---X--?--X-E------oB--?--------B-EBXoo??B?B?X-------o-o-EB-?----Eo---X-?---o-o---MX-?---X------oM--?-------ME--------MM--BBX---X----o----M-----B--oX-E----o-------?o-o-f
-XoX-------o--?o?M----------M-MBMB----M--E----X--B-X----o-----------o--?--E-----------M--o----o------?X-----M?--ME------E------------o-M---EXo?-----XMMo-MM-o-------M---------------MoE-BB-o---M-o-X-o?f
m-o--oEB-E---EX-?---------------oB----BB-M-----------X------?---o-E----o---X?------M---oB-----M--X---X---------EM--------oB----M?B-----?-o--M-E-o-----------o-X---E---X-?---X--o----M-----X-?------X---X
XoE---------Eo-M--M---o?---o-?M----oB--?--B----?--------E--?-B------E---?---M-----o-Eoo?--X--------E-M---------X----------E------B--X----E-----M--M--Bo------o--B-?--------------?----oX--E-----M------X
