-----?--B-?-X-?XX-X-----?----M-------BMoXE--B------E?--M-B----?-E-B------?B??---X-M-M------------------M-MX---?--?o--o-MM--------M----oE-----X----?-?-M---B----BB-?B--X---X-BE-------X--?X-M-o-----?--X-
--M--MB?B---M?-M-M-Bo---?-?---ME--M--B---o----M-------XBo---B-M---XBoo-----o--------E------M-BM-oB----M-------------?-MEoE--E-E?----X--?-----B-E---BXM--------o-?-E--M--X---o-M--MMoM-M-----oE?--o------
--X-M----E--B----M??--EB-E-o-B----MB-B---o----------X-X--o-oB---o?---MB--X----B?o-B-E-------B--M-B--?-M--X---o?M--EoBBB-X?----------o-?Eo------B---?--XMM-----X--o---?--?--B-------E-?---------ME--?----
------------EE--M-----?-----M-------?-EX---XoM-X-----M?--EX------------?----B-?X--M--X------B-oBM--B-----B-MB-----?--M-----M-X?----E----oBE-MM-----E-------o----------------B----B-----X---o-----oE-o---
--?--BB--Bo------?--------------o----o-----M-o-E-EE--------B--?-Xo---B--B------?-E----X-B----B-------X--------------B--o-------o---?----o--B------?M-E--M------------o-----?--E--B-E--o---E-X?XXE-BX----
----------M--X--?-B--M----Xoo-?--M--EBo--X---------?M--------E?---EX---XX---BE?----B------?--X-----o-B---o-Eo--E----o----E---B--BB-Mo------B------------?-X--B---B---XM--------------XBX-----o----o-----
---o-E----o-----?-----BXME---MB---BMM----------o--??----M--M-?----M-Xo-----oE---X----oB----EX--o-B-?-BXB-X------o--X---E-E--E-B--?M---E---------B-E?---X----o------o-B-E------BM--------o------?--------
-?-M---X----X---BME-----X--XM-?----X--MEMB-X----------o-M-M--------?-------X-----??XE-EoE----o---?--M-----X---B-BB?----X---------o-BM-----?oo--------oE--------o-XB--?-B-oB------oX---BX-X-X-M---------v
----M-oXE-M----?--------------o--X-B---?-X-M---oMB-?-----EX---o-----o-?---o-E-------M----M-------------M----B-M-M-M--E--ME--B-Bo---Xo-----?X---Mo---B---B?--------MB---X-X?---X--M-BB------------------f
--E-?-o--MB---o----?-oM-?-B-oo-----M-B--M----M--------E---o---o------X----?M---------M--o---------------M----XE?------?--?-------o-M-?M---M-E-B----E--?--MX-------E----------M?----o--B--o----------E--f
--ME-B-E--------?-----M--B---E--EBB--?---X-----o?E-------------X----?-----?--E----X-M----M----?-M-EBX-E?---B----?--B--Xoo----oo--E---??X--X-----X?----M-X---MM--Bo-B--Xo----M-------o?--oM--E----E-E-B-f
---oo--o--?-----M-B-----------M---oX--B--?-E-------X----E-----X-X-?M-o--?-------M-M?--X--oE---X----M---------XB------B-E-X-Mo-X----B---o-----B---M-E----?--E-M-------B--??oo--M------oM-MB--?M-?M--XoX-f
-----M---B--------o--X----------B--X----M------?o-B?--E----Xo------?X----X-M--X--o----o-?-X----XBMo----E----B--M---X--E?--BXM---?X---o--o-B----X?X-o------?---------??B--X?-BE------??M--Xo??B---------f
------?o---?---o--?---X-o------o---B----XB---EBoM-----B------E--o-----?------X------o-----X---M----EXME-X-B--BM?---B-------------X---M------XB----B?--B---X----E-----B-B-?--E-------X---?---E---?-?-E--f
m-----B-TToM--TE--T----?-o---T---------ToT--TEE-M--?-B--Mo--X---M-T-oEME-B--T-X-------M-oT-T---T-o------E--?--o--TBEM-B-?---ME----------X??-E--E-o--------?--B----??---X--?T-TM--EEM-To---T-T?-?-----T-X
XXXoXXXX||oXXX|XXB|XXXXX?BXoX|oXXMXXBXB|X|XB|XXEoXXX?XBXXXXXXXXXXX|XXXXXXXXX|XXXXXXXXXEoX|X|XXX|XXXEXXXXXXXXMXXEX|XXX?XXBXXX?XXXXoXoXXoXEBXXXXXXXXXXMXXMXXX?XXXXXEXXXBMXoXX|M|ooMBXXE|XMMX|X|XXXM?XXo|XX
