----o-o?o--??---oE-E----BB---X?--X-------B-o--XBM---o---BX-----o------------X-E------X-X-----B--X---------oXB?-----M--BMBEXB----M----M---B?---X--o------------------M?--o--?-BBX?-o------EM-----------?-
------M--E----?-E--B----oB--?-----M-----MM----?M----o---?-o---o-------MB?--------X--B-----oE--E------M-X-?---B-B----?----X-ME---M-o-B--EE---o-----E---------o-XB------??E-E---------?--M-B--X---------?-
--M--------MBX--?---oM-BB-B---BB--B---M----X-----BX----------X-------------E-------E---X------X-?---E-o-----------E------B----?-?----M--o------X-X-o-----oE----X---B-X--------B--?----X--B--X----B---?--
------E-M---E---oo-?X-----o-Xo?-E-----------o----o-X-?X-----?------------B---o?---XE--------B--M----?XoM----o-----E------X-XB-X-?-BE?-X-----?M----o-----o-oo----?------------EX------?----?--o-----X----
--E------------E--B-------X-----B----------BB-M--M--X---?---E--X-------?-X--B-M---M-E--------------XB-------X-----M------M------------------?--------oMXE--M--?-------o-?-E----E-o--B---X-E-M-----------
--X--?-----M-MB----??B--EB-E--oM--o------B--X---------E--oo---------E-X----B?---BM--EoM--B----M----E-o------B--ME------E--oX-------?--?--?-B--??XM?--E-o--------------o--o-B-BoB-------E-MM?---EE--B----
---M-BM-o----XBMXE-o?-E---?----oE----E-X-M------B--M-oX?M---E---EX---B----?o-----?--EM---BMoM------EM-----o----B-M-----?--------M-E-----M----E--------o----B-X------oEX----------E--X?--?E---MB--B--?---
--Bo--------B----oB-E-B----M-XXE--B------M--?-------------o--E------XM-XBB-Bo----?o----B-----M-XEXEB---?---MoB-E-E-o---E-----E--------X---oE-E--EoE--?----o-oo---E-------------o---M-o?-B-X--------X-o-v
-----?----EE--M-o-----------?---E--o---B-M---XX-----?---B--o-----EEE------?-EX-o-X------B---------X----?-o-o--o-----B-X-----EE-B-o--B?------------------BE-o-?X--------oB-E-------?-oM-M-X-M--E--------f
--------B----BM-----B----------M---X----M---?X----M-XB--o-o----B---B--Mo-E----E-------B---E-M----X---M----E?B-M-----o?-B-B?B----E----?-MBM------------BX----M--o-MB----o-------X-M--------------M-----of
---o--BM-oM-?----Bo--B--BBBM-B--E?-B-E--EE---------X--X---o-M-----?--E--o------o-MMM-E-----o--E---o--?-o--M-E--X-?---MBo--X--M--?---M-M------X---M-M-M-?-----X---M---o-E--o-M---XE--Eo--oM---BM-?---o--f
-M-------------X-----------MX---?-E---------M?---E-?----M----?-X----o--BB---?-Mo?--X-o--------E---------M-EM--B------B-M-?---B---BM----MMX-B--------o-X-----------X----BB---------E-B-----XB-o----oM--?f
-----o---?Eo-MB-E--?B--?--?----Xo-M---E------?-----?-o--ME-----------EE--E----X----?--?------B-----?---------B-M--X------X-M-?B---oo-E--B-----o-M-??-----X-oM--o--?-M--X-?M?M-X--M-------B-E-?X---oX--Bf
----X---o----E--E-?E-X---B----XB-o--EE---E---o--ME----------M----B---MMB----------??-?o--ooX-----E--B------M----X-------------?----BM-M---------?o----o-------M?------B-M---------M------B---?--------Xf
m------?------MM--o---X-----XX-B-o----o-o---?-----B----------X----ET-T-X-?-E?----?-XX---o?---------X-o-X-B-B---MB--------XTX----MBE--E-X-o-E-E---B----E--T-X-?---E-B?----o-TB-B-?---?-E-----To?TX-T--X-X
XXXBX?oXXXXXXXXMXBoXXXXXXXXoXXXXXXXXoEBXXXMXX?XXXM?X?XXMXXXXX?EXBXX|X|?XoXEXXMXMXXXXMBXXXXXXo?XXX?XoXXXXXXoXXXXXXX?XXXXXMM|XXoXXoXXXXXoXXBXMX?EXXXEXXXBoE|XXXXEXXXBXMMXXXXX|XXXXXXXXoEEXXXX?|?X|?o|XXXXX
