-----?---X?-Xo------------X------XoXXE---XB---XEE-?E---X----B--M-?X?X---oXE--M-o-o----B-oB-------o--E?--E-------B----X---?-X-------X------XoX---M--EB--B-M--?XB--M---oX-----EB----M--Xo?------E---MEM---
------------X-------M--E-----?-EB-M---B?X--E----?---?------XE---E---BoM?--ME?-Xo---Xo-----BE----o--XoXE-o----X------o?BM--B-X----B----X-----??E-E-o?--XBB--X----B-----M--B--X-X-XX---M-?X---------------
--X-B-?X-------Xo---------oB?--B---M--oX-?M?EoM?---------X-X------X---?------XBXX-------E-X-X----?-Xo-----?-X--o-----B--o--E?---B--E----------B-M-XoM----M------M-------X-X--M--------X--X-----o-?--M-B-
--Eo---X--Bo---MEX--BBo--M-X-o------X-----M-o-------?----------X--M---X--o------------M-XM-EXXX--?X--BB--o-X-------?---B---XM--?-X-B--X?-M--X-M-------M---M---------E-?E------BX----X--BX-M----B--B-----
------B---------X---BM---ME----X-o-X--M-E----------XM-------M---??-BE-BBBX---X-M-X?X--?----BX----XX--?X---X-XM-BE--?M--X-XX--X-B-M-----B-o-----B-MB--X-M--------B---X-X--M----?BB---o?-X----ME-M--?EX---
----oB--o--------o---MB---M----------BEM--?----?----E------------E?------B-----X-?-?---XXEE-?X-EB--X-------o------Xo--X-X?--o-----X-Bo?B-----XX--XX-M-?E--XM----X--E-----M-X-X---MB-o----X-X-oX-X--o--?-
---M-oX--?-X----M--BXo-EX-----------X--ME-M----XoX--E---XX?--M----E-B--X-X-X----B-E---o----?----E---B?-?-M---MXoX---E--XX--X-?-?---EX-----X--B---E-?BB----XB---Mo--o-B--o--o----------X-B---XX--E?----o-
-X--E--X--B---oo--E-XB-------E-o--M-----X-M-M?------X---BX-M----X-o-------?-------X-M-?-X-E---o---M-oo-BMoB--EE---?o---B-E-XXE-M--o?---X----M-X-----o--X-------EXo-M---X---------oB-X----------EE--BBB?v
---Mo-M--X?-----BEXM-----?--X-X--X-?----o--oE-B-------X-B-?B--B---B---B---X-MB-X-BX---MB--X----X-oMM----?o----o---o-B-X-o----E-------BE----o---B---o-?------M-?o?-M-X----?--XB--?M----X--?M-E-X-E-o----f
-----M--ooX-EE--X-EX--E?---?-M-------o?-?------?---o---X--o------EX-E-oo--XE------B---oXX-X-o-B-Xo-E-M-XM---XE--M---M--------oo?XB--XEo-ooX---o-o-----?MXE-----E?-XE-BX---E-EBE-?--?--XEB-E-Xo?--------f
----X---E-X-?o-X-X-----o-M-XXBM----------o--XB-o-E-----B--EM-----XX-B-X-?-X?-----MXX-MXEX---?B-o----oX-X---M--B------X----oXo---------------X----M--M-X-B-oM--------?o--o-EX-----EX-M---X--B-MEB----X--f
-?o-------B-MB----X-------------MX---E--X-Xo?--?-Eo-?--EB-E--E-BE------X-X---X-----?-o---?-X--X------------X-----EBB----E--X------X-Eo---E--XX---B--o-XMX-X-X--?----X----XX--XBE--X------o-M-M-EM----X-f
--M--E------o-o--B-----E---B-MoE--XX--------B----X-X--B-------XM--EMXE--X-----Xo-----XX--M-E--X--------XEBEXo-MBB----EX-B--?XB--E--??---E--X----M-------XEBM-?--ME---?------E-E-B--E---B---o--X----M--Ef
--??BEX---E--oX-E--o-X--M--??Xo--?BX-B----ME-M--o--o-XooX--Mo-------X-XXBXE----E--B--X--E----X--MX----o-----X-?-----B--X-o----M-----M--X--B--XX-------?-o----?XX---XX--X---?--?--oXM-M-------------B---f
m---X------B--XM--o--?----E---X-EooM-X-----------XE-X---EB----E----o-M-XE--o-?-??----X-E-E---MXEX?EX---X-X?EB----XXo--M------?-E--B--B------X--o-?-o--X----E---X-MM-E----MB--M--X-?-oX--------oB-E-?--MX
X---oXo-----M---E-?M-?-----E--E-M---------B-X--BoX-E-EE-X-M---------o-Mo?o-------XME--o-o-X--B--X-M--?---M-----BB-B-----o-M--XX-M----BE---X---B--?X-XBXoM--?---X---o-XEMEBBE----E-XE--o-------XM?-X-E--X
