-------------M-----MM--------o--X-o---?-----------M--B-?Eo-X--MEoE-E----XMo--o?-------E------B-X--------o-MM-----oX--B------------X------E--------X----?X----E----o----E-------Eo---?X---?X------XEBE---
----oX--?------B-oBM--oo----------B-----M------M---XE----?----------X--E?----M-----X----M-----E--Eo-o-o------M-M?-X----E--MM----X-M---X--------X-----Eo--?--E---o-Xo?--B-MX-?----E-B-ME-o-------B-----?-
-B-B---------------XEoX--M---o--BBB-XE-EXX-EX--------X--?----?--B--o----o---E--XE----?-----E--------B---M---B--BM-----E-E----X-------M--EoE--XEo--?-o--X-E-----B-----?--?M---MXXM-------B---o---X-EE--?-
--BM-X?---E----E-M----B?-XEE--?-E---?--E?--------?---EM--E?----X--BE-EE-E-EX--B-oM----o-E---XE-XX--o-------X-o-oX-----oB--oB-M-----X--MB?-?---E--------MB---X--------XM-Bo---X-----E-----------B---oM---
-X--?---B?---------?---X-----X-------X-?---------B--Bo--o------MM-X---B-----E-MXB-M?E--------E----E-BM--o-----X---EoB---X-Xo------M?-B--------B--?----B---??-B-E------ME----oX---X?----M-E--XM---?------
---?--E--------E------M------B--X-?X-----ME--?-X------o----B?--XMME------X--M---E?o--B-E?--?--------BB---M-------?--E-----E-M-o--ooB--M--------Bo--?---o-E--X-X-------o----?----M-?---M-X-----------X?--
---E--X?-----M-E---?----o----B-o------EE---X-BE-o-M--------EBMMo----o--------M-?M-o-?--MMX-B--o-oBB-------B---B----o-EM--X--BB---X------oE--E--B?----B----B---ME-M--?EBMM-----B-----?E--M----X---M--E---
-?----MoM-XE--?-B--Xo-------o----X---E-X-o-X-------B-----?------M--o---o---M-----?---X-MXX-E-?-----------E-MBB-----M-?--------MMMB-o-M-MB?E----E-----?B---?--------?----X-EoMo--------o--M--E-------B--v
-X-M--X?X?---E-----X-oE--MM--o-----B--?o-----XM-------BX----M-----BXM---E-M----E--o--B-Xo--oM----X----o--o-o----oo---------------B------MB--XX------B-o---X??-B-----?E-??--oo?-?---o------XE-----------f
---MXB------?E-----E---?-----X----------M----E-B--------BB?--M-MM--E---------B-------oo---EX---?------M??---?----X?---E--------------M-B----E-?-?---Bo---E-------------oXM---B-X--??-------X-------?B--f
-M-----o----X---M--X-o?E?--EX--?o----X--X--E--o----------X-----M-o-B---------o--?----?--M----BM-B---B-?--o-?----------------EM-E----E-E-X-B---M--------------?--B--------X?-o----B-oXo------B-M-?---B--f
-----------B---Mo--o---?-E----------?---M--o----oE-E---EB------oXE--M---------E-X--E?-o-----B-------?----E?----------BEX------o-?---B-E--BE--o---M---?---------------BM---X-M---BM-XEB--?oEX-XM--B---EEf
-?---M--X-X--Mo--------M---oX-o---------B-MM?--M----MB-B---?----?o-??XoX---X---------?-E?----M-?---o-BM---------M---X--------o-------X---M-?---XX--------Eo-X----oM----------oo--XM?-MB----M?Bo----MM-Ef
--o-X--?-------B---?-o-E--X---X-----oE--------------E----B-E-----B-----MX-X-?-B-Mo?-------------BX-o----M----o---o--?-B---B--B--?--X---B??X----?--------B----M-----X-B----------?o?----M---?-E---B-oB-Bf
m----------MM--oBEE-o-EM-o-----E--M-oo---EM--E--E--MM---M-?----------X----B--?-?X-EE-----B-E----------?--EB----M-o--oX--B---o---o------M-?o-X?BXB---E---M-X-----?ME--?--EE-B-XX--?----XM--E---o--o-XX-BX
XX?oXBXEXXXBXXXMXXXXXXXXXXXXXEBXEXo?oXXXXXXXXXXXXX?XoXXX?XXXXXXXXXXXXXoXXXXEBXXBXXX?XXoE?XXXM?XXXE?XMEXBXXX?oEXoooXMXoXXoMEXoXXXXoXXX?XoXXXXXXMXoXXX?BXBXX?MXXXXXXEMXXXXXoXEXX?XXXEXXEXXXXXXXXEX?XMMXXXX
