---B-o--B-o--------------E?o--MB---Xo-----E-X--------------X---XBB-MMMB--M-----B---M------B------------------X-M---------MBE-E-----Xo-X--?-----BM-X-------M?---------?--o---B------?E--------------?-o--
---EMM--E---E---E-?X-MB-M---------?---EX-------M-----?-B-E-?-X----o---M--B--EoME-oMMo--?---MBB------E-BB---?---XoME?---B-EB----ME-E--B-X--------E---M--ME----X-MB?-------E?-BEX-o-MEM-oM-------E-X------
---B-BX----?-M---M?---o-?-o----XX-----X---------X-----------?------o-------ME--X?------E----X------X--?X--?-----EB-M-EEM-XB?----o-BX--o-?X-EoM------X--Eo-?-X-B-?-?E---o---X-B---?--o--o----XB-BM--M----
-X-M-B---E-----X-X-o----------E----E-o--------XX---Xooo-E--------E-------o--B-?-B----oE--B--E----B---M-Eo-----BM--?-?--E--M--E-----XE---------o?--o-o-B---E-?---o-----?--E-M--oE-----o-E-M---o----EM--o-
--E---------------B-o-B-----X--Bo-o-M-?---MBo----?-----M-?---Bo-----E-?Bo-----------M--M--??--------MM-M--E-?---o---Mo--M-o----XoE-E-X--X---------E-o-------?-----E-BE-X-M-EX----M-X-B-o--X-X-?---EM----
----------?-?--B----M------B-----X-EE-BoE----X--?EBMBM---?o--M-B----X---?----o-?--XX----?B---X-----B-------?------B-?--MEMM--------o-oo-?---o----o--XM---o-------B---?-------?--E--B-B--o-----E--X----E-
----E-?--------X---B--------E----X---B-o----o-M-----E-o---------X-E-B?-B-E------B-----o-BM---Bo--B--------o---M-?B---oE-E--o-?o------M-o-X---?X-B-o-Eo--B--B-X-------oo---E--o------oM-X-------?-M-?----
-?------Xo-X--?-----E--B?-?--o--o--?o---X-------X---?------M--o---------Mo--MX-----------------M--E--B-B-B----X---o-M---------X-----?----XB---E---------M-----------B-EM--B-o-M----B----?MoM-X?---o----v
------B-?-------ME?--BX-----Bo--XM------E-Eo---B------BB----X---E-X----------M--X--BXB----o---E?------XE-EB-M-?---oB-------E--M---?-----X--X?-E----E-B--?-o--------------MEXX--E----o--MM--B-------X---f
----M-??o?----X----B----E---X?--EB-------M--o---o-M?--------------?----E----M-EM----E--X-M--?-----E--E--------X?B---------?-E-------E--------?-B---------?-----------M-X?--------X-oB--------XE?--E-?B-f
----------M--X-BXB----o----o-----EEM---B----B-B--?-M------B--?----B----X-------o----X----X?----E-------o--o--E-o---E----B--M-o---E---E?-------o----B-X--oB--M?-o-----M-----o--X-?-o-o-----------?-M----f
-?------Bo-E-----E--X-?X---------------?--MX?X-B---o--Mo-oE-E-Bo?-E?M-------M-X-Mo------------M-----B------Mo?--E-----Xo-------B-M------B-M----X--E---EM--X--MoBX---------E-?oB--M-E-?-----?E-------B?-f
---B-B-------o---------oX--?----?---M-------E------o--XE-B---o--?----------E----B--EXM---?M-------XE-----------?-E--XE-----BB--o---------E-E--?X------Mo-------?-----o--------M----oE-E----?--Mo-----?-f
---MX-------XE-E---B-----?-?---E----?----E--M?--M-XB----B?-X---E--MB--------B-----??X?------B---M-B-E-X-----------B-E?B------XXoE--M--E-X??--B----?-------E-----------B-----------o-X--?--E-B-M-o-o---of
m-o----------B-----TB-M-E--X--?----------?T--X----TTM-----T-BT------o-TXo-------------?-X---M-----oE--------oo--Mo--B-----oo?B-?-E-MT--M-X-?M--T-M----E-----?--MBT--------TTB--oo--oM---T---E-?B-------X
XBXXXoXXXXEXMXXXXXX|MX?XXXXXXXXM?XXX?EXEoX|XXXXXXE||MXXXXX|?X|XXMXXBXX|XMXXoXXXXXXXXXXEXEXMXXXMXXXXoXMXXXoEXMMBXX?XXXXX?oMXXXXXXMXoB|XXBXX?XXXX|XXXXXX?XXXXXXEXXX|BXXXMX?X||XXEBXXXoXXBX|XXXEXBXXXMXMXoX
