B------------------------------------------------------------------------------------------------------------------------------------------------------------------------------------------------------X
E------------------------------------------------------------------------------------------------------------------------------------------------------------------------------------------------------T
T------------------------------------------------------------------------------------------------------------------------------------------------------------------------------------------------------T
E------------------------------------------------------------------------------------------------------------------------------------------------------------------------------------------------------?
B-------------------------------------------------------------------------------------------------------------------------------------------------------------------------------------------------------
E------------------------------------------------------------------------------------------------------------------------------------------------------------------------------------------------------?
-------------------------------------------------------------------------------------------------------------------------------------------------------------------------------------------------------o
T------------------------------------------------------------------------------------------------------------------------------------------------------------------------------------------------------v
TM------o------E-X--E??--BBo------oMB-E--?--M----X---?----------M-BE-BB---EoX--XXo-XB--B---o-------X??--M-B--o-------E--E-XE---------B-o-o---o----?BB-----MB------o--o-----?-----E-XXEE-o?----X?------??
|o--B-----?--?----M-------------?--XX--?--B----------oB---X--?---E-----X-?-?------------?-M?-B-B-M-X-E-------B--o----B---o-EXB--M------Eo----MM-oBX-----XB--B--EM--E---X-?------BB----o-----X--?M--BE--E
M--X--------oX-B-B------X---o-X-oE?E----?--X-----B-?--?-oX?B----o---BE?-o-E-?--X----ME--------?-MoXX---BM---B-------------X-------M?-----X----XM?---M--?B-ME-BM--o?XX--------MM-oXEBX-?----------?--B--|
B----X---------?X---o?--o-?--M-----Eo-E--o--XX---E-oo?oo--Mo--X----X----o---o----------M-MM-----XX----?X--?---M-?-E--?-----o--?--B-----M-M--B--M---------?----o--M------?--------E----Xo?--------B--?-??
M----oBE-----X-?XoB--X-?M----EBX-?MM---?-----------M-E-E-B-M-?--EoM--B-Mo---XM--o-------E-oo-?E-----------?-B--Eo--o----BB--M?-----?M?-X---?--Bo---X----?o---M--o-M----B?-oB-----???-----?---oXX-------M
|---E-----E-------o---?--------?-?------Eoo---BBE---X-----?-Eo------------E-M-M--B-----Mo--X?BEE---?o----M?-----?E-------?--X-MEo--E-EB----oM-Mo--o--E-B?---?----X-----X----BMM-B-EX-??------MM-------Eo
m---?---M-----X-------EB-----------------X-BX-?----?-XM---?--oB------?-B-?--------E-o-E-oB?---------MX-?-o-oE------B-----X?-M-E-M-?----o-----?--BE-E?-o--M---E-E-o-MX-E-----------BM?-BE----?oo----o---M
X--o?EB--o-?--M-M---B---EB------------M--M-------E?-?M-o-BX----E-B-----o-o----?-?----o-o-Xo-E-----M-?B?----XE-o----------o-----------o--o-----M?-B--B---------M-o-X--E-?---?MB--------?-o--oX----------X
