-M----M-?------B---X----?-----E-X-----M--?-----Xo--X-oM--X-EMX-oBM-B---X-B--o-X---B--------B-M--o-------M-E-E-EX-----?-o?--M--X-?---M-?B?-E---X--X--M-o-MM--B------E----B--?----------Bo--o------M---B--
----Xo-E-X-o-------B-B-----E?E-B----E--B---?--?---------M-X-M?-------E---M--BB-E?ME----B----E----?X--------B-----X-?-Eo-ME----------B-------X--E-ME?-----E---E-?-o--o-M--XE------X---B-B-------------B--
-o------EM---------MB--M----E---o---------B---M-o?-X--X-?-X?--------------M------M-X-X----o--M--MX--X--?E-MB-o----M--X?-?X----MB----E-----X--Bo-------M------o----??E--MXo--oBMB-XB-B--X-?----B-oM----B-
-?B?BX-----M------B------B-E?---B-----E?o-EM---B---oB--------B---------BX-X----E-B----B-MM--M-E-BM-E-X--B-----E-----M--B-----?-?M--M------E----B?M---------E---B--X--E----B--M-o--o--M--X--?BEo---MBo---
------E-M--E-----o---o--X?BXMo-----Bo-?--?-----B-----M-E?----X--?---M----oME--------o-B?-B---X-E---M---B-MB---?---o?--MM-o--E-M-----B--XEB------X--o--EX-M--EE--Bo--o-?--oE--B-------o-B---B-------?----
---BXX?BB---EM?--oo-?--M---o-------------EB--o---B---oEMo-E------X--X-E-----M----X------?-?-oB?o----Bo-----------E-oE-?Mo---ME--M----B--B---?-E-M-----E------------oEB--------B--M---M---B------------X-
---?-----o-------XE-?XMM---------XM----E--EM------X----BEB??o--------X-?-ME------E--------------o--------o-BM--X-----------X?-----------o-X----EEXE--?-?--oE-BX-----?-B-E----EMEX?-?o--E------E----B----
------M-o----?ME--------M-MMXo--B-----?Eo-----M---B?---XBXE--E-?X---o----M-M----o-M----E?---E--?MB?---X--B-B--E----?-o---X-----o----E----M--BM--EB----X--EE---BXoo-MM------X----E--------?-BB--B----X-Xv
--?-X--o--M--------B-------B---o-M-----MEo-----------B--E---B-o-XX-o--EBo---E----X----------o-o----oBX---?-?-------B-E--E--B-o--o-------------BBB--E-M-o-B-B-?-----?--BX-E----o--M--?--E-XE----XB--E?o-f
--o?----B---------o-X--o----------?--B-E-M---M---B---X--M-?E?o---E-X-E-E?--B-----E----X?X-----M---E--------------?------?-----E--?o--------M?-o-MB-----MB----B-B-o----E-o------o--?-E---B-B--E------oB-f
-E---?M-M----?E-E-------?--X-B--------B-?---E?--X--B-XM-M----EB--B------------------X?--o-B--------M-oE---X-?----M-?--M---M--------E-E-?-E---B-?X----EE--M?-EM---o---B-oo--BMM---M-----?M-----?EEB-?-B-f
-X---M-X------B?----M--X?--B--XE-XB--------------M---E?---M------?M-BBM-B--X--Mo-E------------X----oE--XM-------E--X--o--Bo---o----------EX?--X---E--?------B-oB--XX----o-?EE----o---------E---B-E---B-f
--------------BE-B-EM--M--------X-----------X--X-------BXo--Xo---X-?--o------o----M-BB--M-?E-------X-o---o-------M--X----?o-?X---ME-B-E---?--EMB--M-E---B-----B--??-M-M---------------BX?---B-------Xo-f
-?-EoXE-o-o------M-Xo-E?---------M------B--?----B-??-X---?----X---XMo----BoM---E-oE---?-----MX-E-o---X----------Mo--?o-X--X---E----X----E--E---XX------------M---?--B-EoM---o-B--B-?-XMo---X?--X-MM-XM-f
m-B-----B----?oT--o-----?-oo--T-?---B---T--M--E-?E--B-----E-----X-?---M-M---X-T-B--o----------BM-?-----T-----B---B----o--BX-----M----------T?---EXBM--X--E-?---BE---------XM----------BMB---E------X-X-X
XXXXXXXXXXXXoXX|XXXX?MXXXXXEXo|XEXXXXXXE|XXMBXBXXXXXXXXXooXXXXXXXBXXXXXXoEXoXX|XXXXXXXXXBXXXXXoEM?MXXXE|?XXXXXXXXXMXXBXXEXXBXEXEXXXoXXXXXXX|MXXXXBXXBXXXXXXXXXXEooXXXXXMXXXEXoXXXMXXXXXXoEXXXBXX?MXXXoXX
