------------X-EB-----EE---M--------Mo---X-o--------B-E-?Bo?M---X----E-----B-M-M--oo-M---?-?----B-------------EM----o-X?------E-E-?---E-o--B---M----X----X?---oE--M----o----?ME----?---BXo-MB--------M---
--?-?-------MB---Xo--------o--------o-B----o------M---E---Mo-M---?--B---o---ooM-----B--oM?------------o---EE-M--E--M---------o-E--BM--?-----?---M---Bo--------X--------?-o----Eo-----B-----M----------B-
--o-------------X-----B-X----XXB----o-------?---?--B-B--?-Mo-?-----oMMXoM--?-EB-------B--o----------o-------?o?X?---M--BXB--X-X-----------B-?-------------?--X----B-?-E?-----ME-?-B-X---------?---o---X-
---X-B-B--Bo-o?-B-oM-?-E-E------------X----oo-M---EM-EE-o--B-X-----B-----EM--------------BX----?----MM--X--B-o-B-B--?----M------M---?-B?-ooB---------------?o-??B-X---B--M?XB--MM?---M-------?-M--BM----
---ME----BM-XX-?-------------M---XXo--B---?------------X----?----------------o--oM--M--XB--oB----M----B--------o------B----M-X---X--M-EE---------M-?-X---B-M-M---B--------o----M----X-----------X----o--
--BXo-----o--E--------MXM----X------M--M----X---o---o-----E----EE-----?-----M-----------X?E??--B-M----Xo---E-X?-----------------M-E-----?---???---M-----o-----Mo-E--?-o---E---o-M-MMM--B----Eo?E-----o--
-----?------EB-----o----BXoo---?E------------M------?-X---------B-----XM--M----?----------------M---MEB---B--M-X----X----o-M---------X----E-------?------------M----B------B-B?--------M-?oMMEB-??------
--E--M?B-X---E--?B----??--X?----------M-M------E----------M-X---E-M-M-B-EX-?-EE----BM-?B--BE-oX---?E----B--?B-?--?-oXo------B--X---------M-------?-?-B-------X--X?o------M--M-E----o------XXo---X--??--v
-XM-E?-o?---XXE--EXX-------E----?E-E-M--?----?o---?-o-------M---?B-E------?---Eo?-X---Xo-----?-X---EM-----X---o?------M-M-X-o------------EM---EB---------M---------X-------?------?----B-MoB--o?-B--M-?f
-M-?--X------E----M---ME---?Mo-?------X-M--------X------X?-M----o------BMMM-----X-EBo-?--X-o----------EE-M-B-B-------o-M-B------M-?---E----o-----E-E-----M---E-?-M----MM-?----oXB?B?-o--o?---X-o-?--X--f
-EXM-------X-------o?----?E--MBo-M?E-M-??--B-E------BE?-------oX--E---------XM--?--BXoBM-M---Eo----E----oX-M--?-E?-EX--E-----X?X--E---XB---X----?--B-------E-----M------M-----?X----o-B------ME-o------f
-------B--------o--BX--?-M-?----M---BE-?-B-E-E?-------X--o--MB-X-?-o------M--XB-o--XMo--M-B---X?-------o-----o--X-?--X--EM---X-M?-EoX--------XM-B--oBoME---X--XoEo--EB-B-BBE--?----EMM---?-----B-E-----f
---M--E----MB----X-B---------?XXM-o-----o----?B--E?o-------B--------B-E?-o---B----X-----B---?--BX------E--M-oB?---E------?----M-BE--E-EoB-------X-oMM-X-M---X----M???--EB-E----?-----M-X-o-M?B--X-----Ef
-----?---X-E--------------B---o----X--M-B----EB-----o--?---M?-----E-X--------B-------M---X--B-----?--B----M---?-X-M??--M--------------B-------o--X?B-M-?---o?-BE----------E-------B-Eo------E---B--EB-Bf
mo-?--?o--T-E-------XMX---------B----X-M------M-----B---?-XE-----To-E?----o--M------To-X-T--T-----TM----o------T---ET-T---X-Eo-ME--?-------B-T----BEX--BE---X-T-?-o--B---M--?---X--E---T----M-BTB?B----X
XXXXXXXXXX|?XXM?XMXXXoXEXXXXXXMXXXXXXXXoXXXXXXXoXBXXXXXXXXXXoXMXE|XXXEXXXXXXXXXXXXXE|MXXE|XX|XEXXX|X?XXXXXXXXXX|XXXX|E|XXMXXXXMXXXEXXXXXoXX?X|XXXXXXXX?XEX?XoB|XXXBX?oXXXXXXXXXEXXXXXXX|XXX?XEE|XXXEMBXX
