-X--o------o--X---------------------------Xo---o--o--X---------------------------o--------E-----o-X-----o---------------o-XE-------o------------XX-----o-------o-E-----------E------X--E---o------------
-----X----X---------------------o----o--------------------------------X------o-------E----Xo---------------------E------------------------o-----o-o------------o------EX------X--o---o------------------
---------------X--------X------X-Xo---------------------------------o----------XE-o---------------E-o--------o-------------X--------X---X----------------o--E----E--------o-----E------XX-----X----X--o-
-------------------X---o---------------oX------------X---X----X----------o---------XE------------o-----X----E------o-o--------o----------E----o---E--oX--X---------X-----------E-----E------------o-----
-----X---o-----E---------E------XE-----o-----X---E-----------E-o------E-X-------------X-o-o--------o---E-------------------o----X-----X----------Xo------o----------------------------------X-----------
--------------------------EX-oE--------E-----------XX--E----X------X----o---o------------------X-------E----X-------E------E-X-----o-------o---E--Xo-----------X---E--X-------oX--------------------E---
-------------E------X--------------E----X---X--------oX---------EoX--------------------o---E-X--E--oo----XX----------------------EX-X--------o-o----X------X------------------o----X---X---------o-E----
-------o-----o---E---o-E---E-----X-EEX-------------o---------X---------X-----------------E---------X----o-------o------o--o----X-o-----o----------o-----------E-o-----E------o---------------XE--------v
-B---B-B----MB---X--B----------EEB------XM--B-?--o-?B--------Moo---EX--------?-----M-?-M--?-o-----E-?----M?--X--B------X-X----?BEM?X-------oX-----M-?----------------X-----------E--------E-E-Eo-?-X-M-f
--M-oo-X-X---o---X-------X--E----oM----?--E--E--o----o---------?-------X---------E---?-E---X--B--X------o-M-?-M---Xo--B----?----BXE---X------X---BM----X-X---E--EBo-X---M--M-X-?--o?-E---XE---------X--f
-X---------M---X--------EX----M--------?-----M-----E---M-----E-----XE----X-M---B--E-----B-E--E------E----B--?--XE---E-?Xo--?o--oM??-------o-----o----XM-M?M-M-?o---ME---EEM------E-ME--X---EM--E?---oX-f
-?oX--EM-----M----o------E-?-o---M-?---BM--M-?o---B-------B----B-----M?EM?-?-----E---X---?-Xo-----M--o------?--BM??B---o----------------B--o---------E---?o-?B--E--ME----M-X-----B-------EMM-----------f
---E-----Eo--oM---oB-X----E--BE------o--M-----B---?----oo---?X--------EX-X--X---ooXB-?B--Eo--M-----M-X-M---------E----------E--X--E---B?B------------------------??---BE--M----MM---M-----E-BM-M----o-Xf
--E?o-----XM-o-M--E-MB---?--BM-E--BB--E---BE---M-E-?--E----MX--o-M-o-?-B----B-E---------o-MMEX--X---o-E?o--E-X--?---X-M---X--B-o-B----X---M-EMX--EBME---?---o--XB-----o---M-?------XB-o--X-BE-?---o-?--f
m-BE------M-?-E-----MXMXXXEM-X-B--?-----EX-oX--EX-?-?-?-----M-EE-XXo-?X-----X-----X-o-----o--X---?---E-----o-X------XB------------B---o-----------o-M---M------XE---E---XB-----E-X----?o?---oBMM-X-B---X
XXXXMXXXEXXXXXXXXXX?XEXXX?MXBEMXXXXXXoMXXXXXXBBXXXXBXEX?XXXXXXoXX?XoXXXXXXXXXXMX?XXXoXBXMXoXXXX?oXE?XEoXXXBXXXXX?BoBEXXXXXXXX?XXXX?XBXXXXXXMXEXXXXXXXXX?XMXXXXoXoEEXBXMXXXXX?XXXXXXXXXXMXXXXXXXEEXXXXXXX
