----E---o-oX--o---M-----X-?--oM-BM--o---o---B--------X--------------------MM-B-E-M-MB------E-------M-?M---o---X----MB-?-?-E-X----M-------B--------oo---ooE-----E------E-----X-----B-?--B----EM-----M-M--
----B--?----BXM----BE---E--X----oX-B----X-Xo-E------E-M-o----XoM-E-----o----------o-E-o--B--M-Bo----------oM---------E--------E---Mo----B----B---X----X-X----------XB--M---o-----B----M-o--E?------?----
-----------MX------E-E-???-------M-X---Eo--------?---E----E----o--M-M?-----E-B-?-oXM--o-M-X-M?---E--?-M--E---------?B-----------M-X?-----EB-o-EE---?X---o-B--?E----?o?-X---?----------E---B--o--B-o-----
----o-XB------------X------------------M--B-X--X--------------B-----X----------o-X--B-E--------------X-o---?---E-X-X---E--XB-------BXX-------EXM-----------------M-XE----E-?-------MMXM---------Bo----?-
----o-----------B-o-M-------------B--o--?--o-E-?---?M----MX-MX--------B----ME----X-----B--X-----M----?E-E------B-BM--E--?-o-E-X-?-----MM---M-?EX-o-??XXM-o?-E-X-----o-o---------?--------X----------??--
--M-------EMo------BM-------E--o?-----E----o----B----E?---oMB----B-----M-M-----B---?------?-?---E-X---------X--E-E---?-EoE---B----E---o-XX----oE--------E----o--M--EM----?X-XB-EE-------?--X--E----o----
--?X-MMB---------M-o---o--?B-------o--o----BX-B-----?E--o-----E-X-BBo----?---?X----oM--EBXM?---M--oB--BX?-X----------E-?M----X-X----B---------------?-------?-----E-X---X-E---X--oXX-M-XX--o-----EooX-M-
--X----?B-B----E---E?---X-XMMEX-B----B-?--E---E---E---?E-----o?--XM-X--B------o--X---X-?-----B-o-----X?------X--BB----X-o---?-----E----oM-?--X---M----EX-----?-----o--------------Xo-BX--?--B--B-E-E---v
------X-----E--E----B-B--E--M-o-------EX-X---E?M-----X-E-X-o-XE-XBo---X--M?oB-------E?--EEMXE-------?--EX---o--o?---X---X-EX-X--------B---?--XM-------B----o---?--------XE----M-Bo---oX-B-----o--X-X---f
-o--o-E--E--EBB-?------B------MM----o------o---Bo---?-X--------E---oo---Xo--?--MX----?----X----X--o------------------?-E--X---?o-?--B-----E-M----------M--EX-B----?-------o----E----------E---BE--?---Bf
---?M---------------?--------E---oX--E---Mo?---------EM--XE?---X--BE---?-B--o-M----E--E----XB----o-X?---o-?X-----o-----o-M---E?------X?o-MB---M--X--B---------M-EMo-oB-B----?M?----XB-?-------EB-M-M-EEf
-o--M------E--B--B--E--?----X--?-BX--E---XXE--X-?XX--o---------M---M--XB---B---X--XX--EBM------EE-?-EM?----B-XE-Eo---E-B-MoBB----E----XE-------M----E---X--M------M----E-M-?-?-o---?-----E---o-B-------f
-E-M-----X-B---E-------EXEB---E----B--Eo-X?--M-M?-Bo--B---------M---------o------Mo-?-oo---o-M-X-X----X--?B-XB---B------X--E---o-----B--BEE-o--B--o-----B--------MBBB-----o----E----o-E--B----E---XM---f
-------------M-o---M----------X-X-X----o---E--?------------B------oo--M?-M----B----?o-----M---E--E---X--E---M---B----E-oE?-X---M---X---ooM---?-B---?o----------B-----EME-?-MX?M-Bo-E?---oBo-EooB--o--E?f
m-E---EBX--X?-------M--BM-B-E-?o-B--oEoB-----o-----B?-?--ooXE-?----M-M?o-----------E---o--M-B-------MEX----oE---BB---M-E--B---?---EB-----XB--------X------MBBoE-M-?--E--B---o-----X?M-EE-----?---??E---X
X--?--MX-X-------MB-------B-----------o---B-----XXM--------??X----E-E---X--------o-??E--?-----M----E-BB-X---o--------B----B--E?E?o-XoE--?-----E-??---BEM----M---------Mo---?-o----X-M---oM---B----EEEB-X
