-EXX--MBE?--BBEBE--E----E-B--E-EXEo--oEM---X--XE--Xo-EE--EXE-XEBoEXB?Eo-XXME-oEooX?oo-X--BEoX----EEEEBE---E-oM-BXBE-EE?X-E-EX-Xo-E---XE-oXo-B--E-E-X--?EEX-E--X--XEXo-EEXB?-EXB-XBE-X-EXoXXEBBXXEoBXEE--
--ooBEE---B-E--B-Xo-X--XXB-oBXB?-M---E-EBXX--o-EM-BE?oE--XX-X-XX-X--?-X-BoEBEXEXM?EoXBEEMXoE--o-oX-XEXBX-?B--Eo-XX-BMoo?XE?-EEXo-E-?ooE-EX--X--XoME-XXX?o-EXoX-Xo-oXEXo--oE-X-BXEMoM--?EBoEX--XEXo?oX-X-
-XX-XXXE--BX--M-X-E-Eoo--M-EEE-EEXEo-M-EX-XoB-EoB--??-X-oEB-BXE-XE-EEXBX--X-M-B--oBX-EoBXX-BXX-XBM-EE--E-BB-XX?-X--EoEo-XBEEXEB---BoE-BX-BMX-BoXMX--E-X-EBB?E-?E-oBXoX-XB----X-XE--?X-X-EMEoooBBoMoBE-E-
--BX----?EEX?XX??EBoM-E------EEEXBXB-XXEMBE-EE--BM---X-?--XXXX?EE-BMXX-o-oMXX-oE-EEo?-Boo--XoEoBXX-MEXB-XXEEEo?M-ooXEooX-BBXEo--BMEB-XoXoEEBB??ooE-X-E-B-oXE-EEEXoEoXEBEXEMMXMBBoEBBXEEB-o--EM--BB--XEE-
-oX??-XX-XBo--oX---MX--XoXM---XE--MX-E-M-?ME--XE---XE-oB?oEEBX-X-BB--Eo?-BBEBMXoBEMXX-XoXEBE--XX---BEBXoEXEXB-EX-oMEoo??XX-EXoE?-E-X---?E-?--o-EB?--EXBEE--MEEBX?X--BEX-oEEXXBEX-EM-X--EXXXEE-XEEX-XX---
-EB-?-XoE-?oEE-EB--X?E-oX-EXX-XBEE----MEXEoEE----E-o-EBB-EXE-B--?X-MEEBEEEXEB-MM--XXEoXM-B----BB-X?B-oB--MEoEXXE--o-XXo-X-X--XBXXB-XEEoBEE-EoXBEoB?XoXXBoBEXM-EEXEE?M----Xo-oEBBB?--E-XBo?BX-BEEBEXoMXX-
--XEE-EM--E-M-oo--Xo-BM-Eo-EXBEEEX-E?E-EXoXoBXEXB-ooXEX-?EE?E?EoXBE-X-X-?E---EBX-EEX-B?--EMXoEBo-E-X--EoEX-B-M-oX-EooBBBXE-oE-E-oBEoXXXXoEXEX-EBX-XXBX-XXMBE---EoEE-E-EoMEX-o--E-XX?BX-oE-E-o--XoE-o-ME-
-X?-X--oEXM--oMEEEXoEXEMEXX-E-XooX--oXEXM-EM----oooXoMEEE?XB--?-BEo-E---XE-XXEXE-EXE--EXoEBXE--X-?oX?M?--XE-oEo-XXXEEBB?--?--X-E---X-E?B-BXBBXE-E-EooX----EXEB?-?BXB-BXEEXEEEoXBXBEXX--o-?X-E----B?oXB?v
-EXo--E---?oE-XXEE-M-EoMX-X-BoEEEEE?-B?XXMEo-EM--E--EooE-MEXXB---EEEoXXoE-EX?EME-oX--oBXB-?XEoXXBB-?-oE-BXB?-Mo--EBMoE-EoE-XM?M--o-o-oMBXEX-XEXBEXX-E-EM-------E--?X----o-BX--?E--EoEB-BX-E-XX-MoXEEoEEf
-EX-XoEo-?M?-E-XX-BXo-XBXEM-EEX-o?M?---XE-BXXX-XB---XE?B---BM?-XooX-E-XX---EX?--MEX-?EXXoBXE--XMMoEXX-EEE-MMEoX-oEXoE-XXoEEBEoEo-oBB--E-X-EoX-EB-?XXBXB----o----BXEXooBo-X-BXXooXXX-EX--E----o-E-EoXEB-f
--X--EE--X-EXMME?XXB-X-X?MXB-B-XEE--XX?E-E-E--oEX-XX-Eo-o--BEX-------o--XoB-XEEE-X?-BMBEXBE-X-X---XoB?BBBXE-B-oo-EEEXE--M?M-XXEXE-ooEEEE-XXE-EEoo-X-XB-MX?EEoBoo-XEX--?E?o-BXE--B?E--EM--Xo--EB--oEX-E-f
--oXE?oX-EXoM-X?XoXEEX-E-E-EEBMBXXBEXBo-BBEEX-MEE-?---XMo--E-E-EB--ooE-XE-EE-Xo-EMX-EX-X--EBB-EoMB--X---oBXE-E-o-X-?---EoEEo--M--E--E-BXoEE-E-BB-E-X--EXXoEBo-X-ooMBEEEE?M?XBEM--X-BB-E-MX-o-oEE-Eo-Xo?f
-BB-XE?BX--oXXEE-----Bo-XEE-XB-?BE--E-o--oX-??-E-?----B--XEBEE-EB-E?-oEXE--EBoE---oEX--M--o-EE---EE-o-?XX-MEXM-o-o-X-XXoXB--XMEMBEXME?-?E--Bo?EoBE-oXB-XEXX-XoM-X-?EXo-?BE?M---EBEo---?XXX-MB-M-B-EE-Eof
-EX-X--E-oX?-XXXE--XE-XX-?--EBE--E---XBB--E-XooB-EM-XEXMXX--XXEE-EX--o-E-BXoX-E-oEXE?EX-?-o?--XXX-EE-X-XEBooEEBXEB-EX-EX-EE?X-XXo?EM?XE--oXM-XXE--oEMo-?EEXMEM-X-BXo-XEXXXEEXoXMoXMXEoXE--BEMB-X-o---BEf
mE-B-X-X-XoBEXo-E-EXM-X-M-EXXE-XEB-XXMXX-Eo-oEX?o--oXEXE-XE-X-EB-XMoE-E-BX?o?-?BB-X---X-XXoE-X-Eo?XEEX--X-EBBE--B--?-XEB--BXoBBE?BEE--XB---XXM-B-X---?MXX--EEE-EE-EoBoE---oEE-o--o?M-?M?-XMBE-?--XE----X
XoE-X---BoEBEXM-EXB-XEE----EE-MMo-XMXX-Eo-?--XEoB--oBE--E-?Boo-oM-EX--E--?ooE?-XEEX-XBXEX---?E---XE--X-BEB-EXo-oXXX---EX-MXXX--XBEXE-MEXEEoB-Xo-MEooXEooEo-XBXB-o--E?E??E?-XXE--BE--MEEXEE-EBX-M--XX-XoX
