------E-M---B--o-MM-BB----B---?-----ME-----B?--MB?B--o-----?--------------?-------B------M-MB-----MM--?-oX-E-----B?----B------E----M-EM-X-X-----EBE-o---------o--E-----oX?-----?----M?-----------oo?X-o-
------BE------------M---o-----------B---oM------E--------B--o---B--M----?-----XE----?--o--E---?MEB--Mo?M-o-?----o----------X-------M-------------E---B-B-------o--?------E---E--M-BMX---??---?---M------
-?---E-o--M?--B----B-M-----?--X-E-------o-X--ooE-o--?B--o-E?X-------E-Xo---?---E------X----M-----Bo-o-E-------MXX------------Mo-BM---M--E-EM---B-?MB--?-------------MM----------------------?-----------
---B---M-o--B----X-?-----XMX-----E--B----M-----BX-MX?------??--?-B?---?--X-oMB---o--oE?---?M----?MX-B--?-----o--?X----?---B---B----B-B-----------------B?---??Bo--?---o?-?-------B----E--E----o------X?-
--M--?--------o--BM-MX--Eoo---?-?-o-o--X-?----MX??-------X---XM-X--X---------E-B?E--o--oMBE-o-?--XEMM-M---E-E-X--?----BBMB---------?-?-----B---?--Mo------------M---BE---M---??-----E---o---------------
---E---o---o--o-M--?-?-M-Bo-----M--------?B--?--o-----X---M--X-?XM---------------M-oX-?---oX----?---oXEo-B--ME---?-----E---M-XM---B-B--o----B-X-?-----------B--E-----BX-X-o--?E--BE--B-------XX-M-?EE---
----Bo---oE-?---------B--BB--E-X---B----BE--EE-MX-----M-----XX----M?B?--o------?----o----M------------oEE-E--------E---X--?--B-?---E-------------------M--o------M-------E-?---EE-?B??-E----E-M--Bo-EM--
--X--X---o-o--B-o-BoEMB-----E?-??----M--X---ooEM-BM-----E-B-X-----M---M-B--B?X---X-E?-?---M--X-o-XB?-------ooB-B---M--E--??-----XB---E-E-------?-B--------------?-----------E-E---?------oo--MX-----XB-v
-----?-XB--B---B?--------??-E----------X-----------?----?-o------------BMM--oE-BB-B-EEM--------XE--X-X-E--M-----X--?--B--?--B--E-o?--E-oB-----o--M------X?---Mo---o--M----------X-oE-----?---EoXXEB-??Mf
------------MX--E-----------?-o?o--X-----EEX----?------X--?E--X-----?-----M?----B---E--M----E--MME--M--------oX-o---o---BXB-----o------B--M---o-----?--MMM-B------M----BM--E-?---?---E-----X--oM--M--M-f
-?XEo-M------X-------B--XB?o---?-oM?----??---M----o?o--?--B----------o-E-o--M---o----E---M---------------M----Xo--o--M--------XXo-----EM------X-oEX----------E-o----E-X----?-?Xo-B--?--B-E---BEo-------f
----------Mo-o--------M--o--M-BX--M-----oo-------X---EE--E----?-o-o-B--------------o?--E--X-E-------o-o---B--oB--X----E----oEE------?--oE--o--EX-?E---??----E?--------BBM--------M?EX-XE----X---M----M-f
--X-X-oE-M--X-E---o-M--?--o--X--B-?-X------X-B-oo--X--XB-M----EBB--B---M-----?M-------M-Bo-BB------M---X--Eo-?---?------o--E------X---?-------------------?---X--EMEM----M-?--?-EM??-oB--?MXo-X---B----f
-----------X-------E---oE-E----M-E--M--?EM-o?--E-?--------X----B-------X----------??------------oXMo-----XB-------------B--M-------?-------------E---?----o--oBB-B-------EE?----XX--------E--X------E--f
m----E--T---EBM--B-E----X--o-------------B---T-?TM-o--X--EMT--o----E-o--EE-B--X--o------B-?-?o--o-----?o----------X-M---B--?--B---B---E----B---?-B---M--T--B-MX?X-oXo---o-T-o---E?--?-EX-MM-oo--X--?--EX
XXBXXoXX|XXXXXXXXXXXoXXXMX?XXXoXXXXXXoXMXXXX?|o?|X?XXXXX?XX|XXXEXEBXoXXE?XX?XXXXXXXMXX?BXXXXEEoXXMXXXXEXXXX?BXoXMXXEXEXXXXXXXBXoXXXXoXBXoBXXXXoBMXXBXBX?|XXXXXXXXXXXXMXXXX|XXXooXXBMXXXXXXXXEXXXoXXoXXXX
