--?-o-X?MX--------------o------M----------M-?--B-----B--?--o-BM--B--E-?-M--BMXM-----------------B----XB-o---?---B---BX--?-X---oE---?-?---?--XM-oE-------B----------o------B--E----E---ME-------------?--
---------B-----MB-----o-----M-------M-X------EoX-X----BM-M-?--E---oX-----o--oB------M-B---?B-M-EB---B---B-X-----?Eo---M---E--M--E--------o---Mo--oE---EM----E-o--E-------o--o---E-B--?--------EB-Xo---X-
--------o-M-----EB-o----X-------o-o-o---ME-B--oB--M-----Eo---X--M-E--?-X--E-o--EM--?-o-XE-XM--o--XEX--?------E-B----M---X--B--B----E----o-?---E?E-X---M-?---------B-------M-M--o-B-o-----------M---o?---
---?-----?-o-X------?--M--E--X--X-E---EE---X-------M--E--o---B----?--------MXM--E--Bo?o--EM----X-B?B--E?-EM-------o-M-------?-E--B-----?--M---B---EX-XB----------M?X-oE---EEM-??----M-----EE-----o--XX--
----E?-E-M?-B-E------------o???---X---X-------XX-B---EB-----o-------E---o---------E---o------M------oM---EEEX-E-X---oB---o---o--o--?-?M------oM----E-Xo--o?----E--EM-------B-X?-BEXM---Eo---?-o----B-o--
---o----?X---X-E---M-?-M------?-M----EMB-B?--o-oo--B-X--B--EB---?MM--?--E-E-M-X---?X---B-BB-----EoX--B-oB--------?-E--X--Xo---B-M--M---E-BBXB-------EM-------X------------?---o----EM-X-oo--E-----------
--------XE----?o-XE----o--------X-?-o----o------?M----o--M?--MXEE---B-EB---M--------X---X--MoB-----BM-X---E-B--o---------?-M--B-----B-?-Xo--E-----------o--------o----M?----?---?-?------EE--M-XX--Mo-E-
-----X--B-------B-------M--M-MMo--ME-E----oo-o--Eo-?---oX-?--M-----B-B-----B--?---B-----B-BX----M--X-----?-------M-o---B-------XB-X-EBX-o-B?-----B-----B--XoE----XMX--B-M--M-XM?-B-oX-X--?----EX-----B-v
-----EXX-X--E---?---X-----------EB----------E-----E--o------BoB-o--o--EooBoX-----B--o--??-X--oE--???--M--EM-------o--B-------?MB--M?-oM------ooE-o------M-o-oM----?o------BEo-o---XXo??-----------?-M?Mf
---------o-B-MX-----X------M-M--M---?-o-B---M----B-BM-MMo-----B---?-------oBM-----E-B-X------?-B------o---M---M-E--X--M----?-------oM-----B-------X??-E---o----B--o----o--?o-------M--M----o-o------o--f
-X-B--MXX---B----Mo--X--o--MM----X?-----------oX----?o--M-----Eo-M-------EM?--B--M-???--o---?--------------M-M--X-X------------M--?-M-M----M-ME--M?----EX---o-----?o--BB--E-B----X--X?-?o-?-----???-oM-f
-B----E---??E-E--XoE---B-BXE--E--B-------------?-M---BEo--------?-E---?-M------X----?X?------MM---B--X-XM----oo-X----?--?----o---?------E-o?--EM--E----M--B----oB-X-B--EMX---X-----EMB----o----o--MXE-Ef
------?---E-----o-EM------EoB---------E------X-o--o-?------MB-----?X-o-E---BEo---E--------------?----M--X--Bo-------o?--o-o-------B-E-E------M----B--B--BXX---BM--o--?--M------M-B--o--B-MX-o---E------f
----?---X---X--?-?-B-----EM--E---E?M----------EMX?---------------B---oB-E---------M-----MX--XMM-M--o---?--M---E----M-B------B---X--o------------M----?B-o----X----o----BM---EB--------M?-o-------?---B?f
m?---X----B-o--------o--BB-----BE-----BM--E------o--E----EX--E-MEM-------?---o---?--------?-o---M?E---BB-----?--o-ME--------XE?---E-o----M--------M--M--o--M--------EoE--X--M--B-----XXB----M--?B---X--X
Xo---X----X----B-----o------?------------E---B-------M---XB-o-BE--------E--o-E-BM-E---EM----?--X---------X--oE---E-----X--X-------M?oM---B---XB--o?--X-Eo----?-M-E--o-X---------?BX-----E---B---M---E--X
