--E-EXE-E-MEEB-E-X?E--XE?XoEo-X?X---EX-BEB-oEX-oEX--E--oo--E---X-oE?X-oXXEXXoEXo-EXEEM--EMXMoE-XX-E-?XEX?oB-MEB?-X-BMB-XX-MX---B-----EXBXBoBo-MEE---X?-XXE-MoEo-X-EM-MoM-MX-?B-Xo-??EXX--E-E?XXXB--BE---
-oEXMBEBXo-EMXBBoE--XE-oooE-X-M-X--E-X-XE-X--o---E-EE-B--Eo-oBoXXo-BX-EEoBXXM-XEoXX-X?Xo-EEXE-EBEE---EB---M-?BM-E--B--EEEXXXMBEB---ME-EXEE-EBEX---MM-EE-----M---X-M---X--XE-?---oEoXEE-B-E--BEXM-?X-EXX-
-XX-X-BE--B-o-MEo-EMBEE-BEE---E-oo-E?--EBE-oX-EBEMBEXXEBXEX-XoB-X?-BXX-X--E-oXEXXM-?EE--BXXE-XE-X----EEEXEMEXXXEB--Xo?oX--?E-EX-X-?BEEXXM-??EEEX?-XoE?-EEo-oM--EBB---XoXoXEX-Xo--o-o-oM--XE---oX?XEEEEo-
-E--EXoBEoXBoEX-BB-X-E-E--o?--X-o?--o-BEEE-XEX--BX?E-X-E--oM-E?ooMo--XB--XEBooEX--XEEEEo--XE-EE---B-ME-BXBMX-EMEB-EX-EXBEo-E--?B--BE-E-E-BX-X--oXE-oXXXo-?-Eo?XEXBXE-M-XXXoBEXE---BB--XXMB-oME--B--o-X?-
-XBXEoEB?BB-Eo?-XE-oBX----E-EEEBB-XoEoME-oE-EX-EXXEXMBo---Eo-?XX?EX---EB--BEEXoM-BEooEB-BoXoEXEBEX-XE-XXBXoEo-XEBX-EMB-Xo-ooB-B-B-?-EEBo-XX-X---E-XM---?BEE---XEX-?XXoX-E-?BMMoEM-oE--X-M-oE--EEEo-oX-E-
-BXE-XE?-?-BXE-MXBMoMEE--EM-EE?--E-oEo--BXEoE?-oEE?--?X-Bo-EEE---XooBo-XEXEX-oXo--ME-BXX-XX-XXBX--XEXo-Bo-E-XBE--X?---EEE-M--XoXXE-B--oEB-E?BE--oEoEXEoEEBEE-XX--X?-o-X-EX--?M---E?---EMXE---X-X-X-M-oE-
-XEXBEXX-o-X--oE----X-E-X-EXX-XoEXB-EB-BXEoBoEXE-BBEBo-EBEXB-E----XB-E-EXE-B-XMoBEX--EXEMEXE---EXEBE--XBX-XoE?--?X-?----XBBBMEXXB---Eo-XEoEXXX-X-EEE-MB--BEXEX-EEXE-B-XXEoXE--EXXB-XXXX--XoXE-M-EMBoEBX-
-M--o---E-oEX-X-XMEE-MXBEo-B-EXXE-EE--B----EoB--E-X-E-EXEE-oBE-M-oEBo-?E-X-E-XEXBXoXE----XXBBo-MX-B?ooX-X--o---XX-EEXMEBEX-EBE?EBoM?-XM-X----EB-X-XEo?XEoBoX-?-E--E-X-E-EBEEo--Bo?B-XXEoEX--?-MX-XMXX-Xv
-X---XXoEBEXXooE--XME-?EMEoMX--E?--E-XBE?E-X-EEoX---BX-BooEXo-EBXE--B-BEE-EB-B?-E--XM-B--?oMXoB-E--X--MXEXE--E-BXX--XX--M-B---oBXEoXE--M--BEX-XE-EMXo-B--XXEX--XXoXEMX-E-X-MEXEMX??XEXBEEEBMM-EBE------f
-Xo?-o-o-BEEo-oBo--XMEEEEE--XXXMM?--EBX-X--XEo-MB--oXooEBBM-EXEEXEM-o-o-X-X-X-EEBoX--XEBBB-o-XoBE--EME-B--XEEBE-EXEX-E?XE-X-B-??--XE---oo-XoEE-o--XMXXBXoEB-E---MX--EMXXXo-?BEo-oE-XBXoEXEEBEM---BoXMoXf
--EB?BE?-XoEE-E?XEoEE-X-XEoB-Xo-X--X-X-EEXo--XEBXXXBXEo-oEE-EEEXBEB-oEoXEEX-EXoXEEB--oXEEE--EBEXEXXo-EEXooXXEEEXBEXXBXX-XEBXEEoXB?B-XoEoXE-BBB-M-E-E-?---XooX-XB-E--E?XBEE-XEMoEo-XBM-EMo---?-oBoEXoE-Xf
-BMoBo-XEE--?--oBE?-X?XEX--EB--X-EXEEX?B-oXEEoBE--?-EBoXXE?oEEBX--Eo-EX-oEBBo-B-XBE-XB?MEXX--B----o--EBEEXB--MoXEE-XXEEEBXXX?EXo-X-EoMoEMo-MEo-E-EoMEEBMMXXXE?-XX--MoM-X-oEoXoXMEEBMB-EXEoXoXXXEB-oXMXof
---XXMBo-XX----EEX-?--?oBXBXXoEoE?E--XX--XMX-?XE-XMo-XBX?-EEEMX---M-B-XBooXM--EEB-B-?oEMXMXE-----oEXE-o-E-B-o-o?E-XMEE-o-oBoXM--B-BX---oo-EM??---EoMX-EBEEXoMEMX-X-X---MXE-XEBE?-oX-XX?---oEo-MBEooEXB-f
--EXXEEEX--oEEXoBEooo-EEo-XX?X-X-XEE-XXXX--XX-E-E-X-XXX-EE-?--?---E-??-oXXM-B--EEMo-EoXXBoXBEBX-EMMoEE--X---E-E-o--X-oXEX-EBBXE--?BoXE-EB--?-EXX-BE-oXEXB-XXBEXoEM--?XoX-XX-EB---oMM--E-oEXE-??MoEBEoXof
m?-EXX--M?BX--XEEE-XXo--B-EB-oXoB?X-EEBXB-E-o-B-B?BM-X-E-E-EE-EE-?o-EX?-XEXXBEE-BXoX-BM-EXEE-B---XB--BoEE-BooXo-MX?---oE--oMEXBoXo?E-E?EBoX-X-?-E?-EX-X---E-EXXXXEEXo-B?E-EEoo-B-B--oMo-BXBoXEBoXE-oXBMX
XBXE-EEEEEXX-EEooE--EMXBB?--XMMXEEXBXBX-X-EE-EM-?E---E-X-o?oX-X-X-XE-E-EXo-EM-o--E--oEXoXEXEX-E-XXX-XEBoEX---EEXEEE--EBEBXX-XXX-XXXo-XEXE---EE?-XEEE--BX---B-XXo-XXB?B-X-XEBM-M-EX--X-BoB-MBXE-?MBE?XEEX
