|--X--------?-----E-?--------o--XMXE?X----M-----E--BEEX---o-----------B----BBMB---B--?o---oo-?-oM----M--E-BMM-o----X-----------o--?--E----?---BE----XE------E-?B----?--E------EE?-o--------------BM-B-MB
E-----?--M?oE-X------B----E-----o----E---o---X-----------o----X----B---o---?----B------------B---o?-Bo-E--?----o--B-M-M?-------M------o-----Mo?-X-o---o--X?X---M-------MXoE-----MM-?-----B-o-----------T
|---------X?--MEE-?B--Xo-E----M--MB-EE--?--M-X-----BM?-o----?--?----------M--E--XX--?-M---E-o?-B----B-o----------E--?oM-X--o-o----E-o---M-----BEE----E------------BM-X----M-M?X-------M--o--X-?X-o--o--?
Mo---o--------M-o---B--B---X--M----B-Xo----o----?------?E------B-?-?--------BMM--Eo--------E---o-?-E-X-?XE---BEo-EE-----B?--B--M-EM---oX----oM-BX---M?--E-X------o-X--B-B--X-M-o-X-?-----?-------------|
E------o-?B-E---BX-oo--EM-X--o--M-M--?o-?-?--o-M--BB??--M----BB------?-?-----------o-------BEB---o--X-------E-----B--X-------oB---EB--------XE?-o--------E--?X--E-M--Xo-?-o-M-----Mo----oX---MM-oM--?--E
oB--------BB-E--oX-----o---XB------E---X-E--B-o------M--B-E?---BM-----B--oM-XB---E--M---------?--------------XM--Bo---X--B------M--?-E-----------B---?-Bo---X--X-?---?-X----?--oo-M-X------M--------M-oX
oX--E-------E-?-o-B----E-----oE---XBo------------------X--E----------E---M-M--M-oo-M----X?--B-----X------?-oX---?E---o--MM----E--M?B---B-----------o?---??M-MoEX--Xo-XoB--XM-Bo------B-MEo-o-----M---ooX
|oB-------X---B-E-?-XB-?-B---?-------o-----E-EBEB-M-o-----------B-B?--M-?----?-B----E-B--?o--oo------------E------BM--B--M-----EMX--o-------o-M-o-o---oE-X---------XEE-o-?-B--E------------E---X------Xv
T-BM-----B-B-------X-M---M-------Xo--------M-M-X------X-E-M?--M-M?M------XMo----M-------B?o-B----E----X-----?--B--------X-B----B?--B--B-?M------------E--?---------EB---------BB-------B---Bo-----?----|
B?-E---?----M----M--o------E-MB-------M---------B?o----o----?--M------X-M--------X?X--M------B--o--Bo---B----MoB-----X------E----EE--?-?------E--M--E?-----o---X---M--E-B?o-oB--E-M-oMMM----ME-BXBoEE--|
X-?--M--B----ME----------o--?-ME-X-oBX--------------B-?X---M--B-E---E-o-------Bo--M--E?-o-----?-o------MMo?E---------M--?MX--M------E---Mo--?---M---X---M--o----B--?-B-M------M----------?B-o---X-X----X
M-E------M?-?--XME--B--E-o-B?---B-----B?---?--M-B-----X--oX-?-M-------X---B-------?----o-EX?o?-B?-M---B--o--------E---E---ME---?---Bo--o--------M-Bo-o--?--Eo------------E-----?MoB------ooX-M?----E----
|-B-X-------o----B------X---E-XXB----------E--M?----------o--XE---------E-?MB--E--B---------?---?-----E-----E-oMoo---?--MX-B-----M-----o---MX-B---------E----?--??o-----Eo-E--E-E-----X?---?-----o---X--
MEEX-?--X----M--o-------o-----?--X--??-----?-----o-B----B-?--X----B---X-------M-----X--M-M----?-----o-?---------------EEX--E--o--B-E--M-M--o--o-----?---------B-o-M-E----?--------E------X---X?-------XX
m----?---E---E------EE-?-M-----E--B-B------Eo-X?-E--X-B-?------X--ME--E-----o-X-M--ooX-ooMo-o?-----E-o---oE---------X-----B--Bo-----B--o?----B--X--B-BX-M?---X-X-?---M-------E--?-o-----M---------M-o-Bo
XXXX?XXXXo??XXXXXXXXXXBXXXXXoXXXXXoXX?oXXXXBXXXooXXEXXBMXXXBXXXXXXXXXXXXXEBXXXXXXXXXXEMXXoXXE?XXBXEXXXXXXXMX??BMEXMXXXXXXXXXXXXMXXXXXXXXoXBXoXXXoXXXBXXXXBXXXXXXBXXXXXXXMXXXXXXX?XMXXXoMXMMXXXXXoXXXXXXX
