-?--M--B-oE------?----ME-------M-----M--B?------o-----M----BM----X------------o--------------o--E--------------E-o------------M-Mo-M----B-X-------?----M---E--M-o--o--X-?--XE--?-----o---------ME-X-o?--
-------X----EE-----X-o----M-X-----?-------o-X--X-M---??--X-?-----M----XE-MB---X-o--XB---M--M---?B-oo-B--?-------M-----------------o-E---XM?-?Xo-----M-?-X------?X----o--?----XE--B--B-M-----------EB--X-
-Bo---Xo---?o-?-Eo-X-M?--oo-o-------?----M-E----B-------M-X---EB-B---?---B---X-E-o-o--------------M-o-----B---E-B---X-X--------XXX-XM---XEE-oE-?-B----MM-M--E--o--o---X--------B--MM----E--E-E-----?-BM-
--E---Bo-E--M-M?---------E--o---B-----M---E-----?-----------E-----------X------?-oBo--B---B--------M------------?------B-?--M-M----BX------E--M--B--E-?----oBE-M-----E--E--?M--------E-E---M-X----?-----
-----X-E-?---------MX-ME-X------?M---B-----EB-------?------B-B------M-?ooM--------------MX---?----E-----B-----?-----o-?-------E--B--B-M-Mo--X-XB--oB------B--X--E--------?-------M--EB----?B---E---?----
----B-o----M---?--B-----------------?------?-BM--B-E-------------?-------B--M-M--M----B-oBXMXo---o----?o--M--------E-B-?--?-M--oE----EMM--------?B------oB---------MXXE-------o----------E-------B---M--
--?--------B-?----E-EB----??E--Bo-----o-oMEB--?---?-MBo---?X-E-------?-XM-oE--------B-Mo-?--?BX--E?---o----o------o---E-?--MM----EM-?-?-----B---B-------M?-M--B-?E----o---?------M---E-----MB--EB---o---
-------X---B-o--E----M-?-------o---------M-E-----E-o--------EE--MM-E--E?E----?------B---B--?--o-M-------?-M---X---B-?-----MM?----?--M-------X--X--X--E?-----X------?--------o---B-o-o-----EM-----------v
-----M--M--oXM----------?MM--E---?------MM--?---E---M-EM-----o--XX---E-----B-?o---?-?o--B-Xo-X-B----o-E-MME----?-Eo--------X?E----E-----MM---E-------M--?---?-o------oo-----E---B-M----E---BM-------B-of
-?----oB-EB?B-o-E-------------------oo---------EBM-E---BE--X-Eo-----M--------E-E?----X---o?-E------o-------X--MM---X--------------?B-M-X--E-B------o-X---E?E-?----?---ooMMoM-------E-B---XMB-----XX-E--f
-------o?------E--MX--o?--M-BB?--o-o-------BM-o-?E---?----------B---o--E---MM-----X-E---?---B------X-EX-------------?-------------------E--o-M-----B------o-----X-M-BME-------------E---------B---?--X-f
-XE-----M--?--M-?M--?B-E---E--EE-------E-E-B?--E?-XB-M---B--X----------------MEX------------------?-o-??---X--X--?------XB---E----MM-oXo-o-X-E---oEM-X----E-?-?----XB----oM--o---oE-E---M---MB--o--XM--f
--o----EXo-oB-o-oXBB-----X-------X-B-------B--?M--oMo-E----?-o-o----------B-E--E--?--------ME-----B----?----X-Xo-X-------------B-----o--?-o--Mo--EB-EB-oM-----o-----B?o------M-------X----M----------oBf
--M-M?-----BM---BE?-E------?------B----B-----------Eo-X--?--M--------EE---XXB--?E--------?-MXEX-X--o-E-------B--B-?--?-----------X---oB-BM--------B--E------X---E----------BX-?--X---?---X-M?--o--B--X-f
m---BE-M-------B-o--T-?--XB---oX---M-?X?T-----------?------T--Bo------Bo-------E---E---------T-----ETB---X--XX--?T--?X--M-----X?M---ET-----EM-MBo--oX?XX-------E--T-------BT-BBo--M---X-----X--M-X-B-MEX
XXBXXXMXXXXBXXXXXXXM|XXo?XXXoXXXEXXXXXXX|BXXX?XXXMXMXEXXXBo|XMXXXXXXXXXXMXXXXMXXXXXXXBXXE?XXo|EXXoBX|EoEX?XXXXXoX|XXXXXX?XoXMXXMXXXXX|XXo?MBXEXoXXXXEXXXXXXXXXoXXo|XMBXXXXX|XXXXXXXXXXXXXXXXEXBXBoBX??XX
