-E-BooEXBE-X-XX?-XEMEXBXB-E?-o-EBB-EBo?--Eo--oEE-B--o-EXMEEE-BEX-XEE-EB--E?Eo-EXMM-X-EEX-?oEE-oX-M-EXXEEE-?X-XoB-XBEMM-M--EBX-XoEXX?MX-M-X--XBXE-E-oXo?E-EXo-MEEEE-EB--Eo?ME-EB-X?-EXBBE-E?X-E-EE--o?EM-
-EEB-EBBo-XXEEXXEo-ooEoX-B--o-X-XXoX--Eo-X?-XMXoBE?X--B-XE-EB-EEE-oX--MXXXM-MXXXB-X-EBEEM-BBBEBX?EEE-B--ooE-BoE-oE-X--XX-EEo?X--EEXX?E--EX--XoXXX-?-oEX-EX-EXX-BE?-oo-B-Bo-EE-X-oo-EXXX--oXEE-XooX--o-E-
--XM?X-o--E?X--B-E?M--B-M-XEBE-EEo-BEEEXXE?Xoo--EX-EoBX-MX-----EEBEX---E-XoEX-EE-oXoXE--X--B-MEE--EXX-X--EMXEX-BBEM?B--XE-BBXEMXo---o-XBBEEoB---EBoBM-XE-oXME--EXE--B-Eo?-X-XE--E-oX-MMXo?EEMooE--E-EXB-
--X?XoXMEEX-E?-oX-?EB-EE----EE-E----o--B-?-EX-X-XXXo?BE-B-EX--oB----X--E-MXo---EE--EBMX-EX-E-?XXXEX-XXEXE--X-BEBE?-X-X--Xo-?M-EX--o?--oo--EoooMXBX?o-BMB--o-E--XX--X-EEXBE?-XXBEXo--X?EBEE--XE-?o--B?B--
-oMMEE------B-EBEB?EBXoE-BEME-XXXoXo?--XEEEEXBXEEEEE-X-E-?o-EXo-X-oXE---oEEEEXM--M-EEXEE----B-E-oXB-EEB-EXEXBXMX-EE---EXoBXMXXMEEXoB--B-XE-BoX---oEXX-EEEBEE--BXEE-M-oX-BEX-X----XE-BBM?X-EBE?-E-XoEXX--
-XXBBo---E?----X-----E?oBo-BX--MEE----X-BE--X-BXX--E?BEEXEEXXo?oX---XE-XEE-o-BBBBEXo-?XM-EE-XE-Bo-o--oEXEB-X-BXEEEE-oBX-E----EX-EE-X?BXE-XX-----E-BBBEoE--EEX-X---XX----o-XB-E-o---B?BXo--XME-B-??---X?-
--X-X-E-EEX-?XXEE--E-oEXoE-Xo?B-E?EoX-EoE-B-XMXMMX--B-BX-BEBBXEM-BEXX-EX-XXE-oE--BBXX--EBXM-oEXXXB-BEXXXEEoE?-X-MEBE-XE--M-Bo-X?XEXooMMXE?BMXB-XXX-XEXBM-X-?-XM-X-oX-X?--EEM-oX-BE-MEX---oE-XEXEB-E---o-
--B--BBXEEE--oB-Xoo-XE?-oEX-XBo-?BEBXEo-EEEX---B-XM-EBX-XXEXEEXEEoo--MXEX-XEoXEXX-E-o-B--EEMXo?B??BX--EMo-o-oEMX--XXoEoBEXEEo?XoEEo-o-XXBEXXoEXEXBoEB--?oBXEBE-EB-o-X-??XX----E-XEX--XEE-XE-B?B?-?o--EXv
-EBE?-X--EE?XE-B--B---Eoo-E-BX-oX-X-XEXM-E-EE---XXE--B?-EEX?oXE-X-?XEXX?-XE---XEXBEEEXXBMEME-EE-XBXEoEE-X-EX--EX-o-XB-B-?-BX-X--MEXMM--X-MB-BXBX-E-XE---E?XE--XEoXEB---EBX-oE-XEBXM-EXXo-BE-?E--XEBBX-Xf
--E-Bo-XX?--EX-o?--EBB-EB-EXEEEoEX-EE-B-EBXooBEE-EB?XEXBXXEXE-oE?-E--BEB--o---?---XBXEEE-EXEB--BBEBXXBEo-XE-MEXEBBX--B-BX?--o--ME?XXX--E--BoXoX-XXo--EXE-XX-----o-o--oo-EXo-EEEM---?--?----oXX-oX---oE-f
---EEEX-oo---EMEEoEXX-ooXoE---oX-XB----EX--ooo?B---X--EX-E-X-X---o-XEE-EEMM-XXEX-Bo-----XEBo--XEoEEX------oEEEoXXEoX?oE-EE-o-M-o-E-XXXoE--M--BE-MEo-ooEXo-BBoE?XXEBoXBEX-E?-EMB-B-XMoX-BBoXXooB?--?-XE-f
-oEEEXoXE-o--?BB-EXXEXEX--o-BX-oXEX-Bo-oBo-X?-E-X-X-?E-X-XooXE-E?--XE?oMooB??oE---X?-E-B-X--XEXX--E-E--?E--XM--X-XEX-BEBXX-?---MM--XBM-X--EEXX-EE-B--XEXBBEEM--oEME---B-XXX-E-BooM--EEX?XB-BE--BXEB-o-Bf
-EMEXB--BooMEoEE--XooB?-M-X-X-X--XBM-oBEEBE-X-EM-M--BXEXE-X--BEX-EE--EBo-XEE?E-E-E-XX--X--oo---EMMXX--BX-oEXEMooX-XEE?--o--B?EEoB---EE-oXXo-BEE-oo-X?B??BEoXBX-EE--X?XBoBo-E-EE-EEXE?ooBoEoEXXMBX-E----f
--XoXEX-?EXo?-B--XoXoB--B-EXMEXooX-EE--X-BXEoXXXMX-XEXX-------ooXMoooXo-M-Eo-XEEXXEX--EX-E-?BX----XXo?-X-EM--oEX-EB--o-?-XE?-o---E?XEMBoBXXEXBBXoMEX-XXXEB--o-BE-B?EooXX-MXo--XE--E-E-XEBBX-ME-EMXXEX-Mf
mXBE?E-E--?XXXE-X-?--oBXXEXB--?-XEE-?X-E-X?B--XE-Eo-ooE?-EXoX-?MEXEX-X-?XEM---?XXMB-B-XX---XEoXo-oEEBX-XX--XXEoo--?-EoBBMo-E--EEo--E-XEoEE-?XX-E-X--XXMXEoo??o?-Bo-X-XXMBoo---oX-?B-E-E??XEEE-?-BX-X-?-X
X-XoBX--?-X--B---M-oEEXB--B-EE?oEXEE-o-B--o-X---EE--?BoE--XMX-o-?-BEX--X-M---E---X-BB-oE--EXoo---XX-XXEX--E--X-EXBB--?B---BXXXE-XX?-XE--X-XX-BE?E-oX-oX?ooB--BE-XE--EXEE-XEE-EBEMXXo--oXXX?EEoB-X-?E-o?X
