------?B----M-B?--M-E-----BMooM-E-M-BXB-?X-M--XM-X------o-M-M----X---EB------o----ME?X------------------?-B---E-M---Bo---X-B--X--------------------E---?oE----?--B-BX---?---o---B------E?MM-X--------B--
---B--E--B--M----------X-------M--B-----EX-?Bo---?--?-----?--E---o----?--------E--X--oX----??-?--MM-?Mo-------M-o------o---MB----X-?----B-----?M-?X--E-MX-E-----XB-o--X------M----EE-BE-MEM--B---M-X?---
-M-----?B---M---?--------E-X-E------M-M-B----------B?-----B---X---M-o-----EX----X---BX?----------------oo---X-Xo-------?---E---------------?-o?-?----o-M-X------?-M-?----M-o----o-EE-MX--E--------------
-----B-M-o-B-o---?------B-M--?--M-B-------?--XBX-------oM-E-XB-?X--X-o---B--X-?-BE-M--------EM---?--Booo?-----E-BX---------E---B--EEoo-----o--EXMX--------------E-B----M--B--o---B----?X--E-o------M--o-
---B-BM--o--?-E-B------B------?-------B-E-?-----EX--B-o--?----B--------X----oEM-?-----o------?--X--Boo-----?-oo---------M--------oBMX----E--?E--X-B----B--------o--X-------E-B---X-X-BM----??B----ME----
--E----M-ooE-o---MXEE---Xo-------o-M----XE-EMM----EX-?-----B------o-X-?-EX--M-E---------M--E-?------?-------oE-Xo--??--M--XE----ooM-?-XXMoM-Boo--o-X-----X-??oMo-XMo-M---------------BoE---M--BX------E-
---B--------o----EE--E---B---------X---------E---E---------M-MXE-X------B--M?--EB---EB-M---?-E-EXE---B--E----X---X-BE--?-----M?-M-------------------------------M---X-----B---MM--??E-Mo----E--EM?B-E-o-
---?---X--X------B--o-E---------M-EoEE----X--------X?EX--B----o--B-o---X------X-M----E-----EMXE--------?----E---M--------------MB?-----B?o---X------------o?X---------E---E-B------------BM--------MMEMv
----M----B---------------Eo--E----MX?M----o---XX----B----------------oXX---------E---------o-----B--?-EX-----E----MME-----X-----------------M-XE----E-X-X-----------Bo-E---B--E--M---E---B-oo-----?----f
----B---X-X-o-?X-?M-?---o-------BE-?X---E-?-X----M---o--M----E-XX---BME?-----o-----M-----------------B--?----X---E----X----B---E--XXE-B----B-o--X------E------??----M-?-M--XX-------E-------X-BXEMM----f
----XM---------X-?---M---------o-E?---E----E----E-------o--B?-------M----oE-----B------------E----?-BM---X---------------X-X-----o---E-oXE-o--------B-------B------M----X----M-ME-----X--E--------?B---f
---M---------EM--?-X---oBE------B----?-E-?--MX------o-?-E-X-?-M----B--o----o------M----------oE---?-Bo?-o--o--E---M--o--M-----E---M--?-B---XM-BE--------------------------E----B---o-oo---M---o-?-M----f
-B------o--EoEE----?--M--XX--MX--------B----B-E-?-oMM------?---??EE---B------X-----?-?M--E------oMX--EM-MB----?X--E?----BX--oMM------B-----B----o-----o----MX---BX--E---o--B----o---E-E??--o--?------M-f
---M----MME-X-?-B-----M--E-o---BooB--E--E-?-?----?----?-B?---o----MMM--BBX--?X-BX---B---?M--B--?---?-B-XM----M-B?----E-?---?----M--M----E---M--E-----M-o-EM-------?---MoBoX-BM---BM--?--B-?----------?-f
m-M--B----M--M----B------------M-E-B---o----o---B--o?EMM----M-------------M------B?o?-X--oo?-oX--o----------BE------o-?--o---M--X------E---X-----E---B-M-----B--?--------M----XM-M------X----EM---o----X
XXXXXXXXBXXX?XXXXEX?XXXXXXXXXBXXXXXXXXX?XXXMXXXXBXMXXoXXXX?XXXXXXXXXXXXBXEMBBX?XXXXXXXXXXXXXXXXXXXMXXXXoEoEXEXXXXXXXXXBXXMXXXXXMXXBXXXXXXXXXXXXXXXXMXXXXXXXXXXXoXXXXXXXXXXXXXXXBXXXXXo?XXXXBXXXXXXEXXXXX
