----MM--?M-M-----MEX---o---------------E----------o-------B-------------E--B---------E------E--B--M--M--o----B---------o-o?o-------?----?BM--M----------oM--?--------------M-----?---B---MM-o---E--?-?B-
-------o-EXM--------------EM------X---XB--M---B-XBM--E----E-o-BoE---------o-?---E------o-----M-E-----------B?-----oE---?-B?M-----M-----X-------M----E------?o---B-E---M-?---EX----?-EX-Xo-ME---B--------
-?-----oX----?M----------XE------XE-Eoo-B-BX---o-M------E-X-B-o------??--E?X-?----M--------M--EE-----X----?-B--o--M-E--?X--oM---B---X---E---E-----EX?-----M--B--E---XX--M---?---BM------------B--XE-----
--E------oX-B----?---M----M---?EE--E---X--------E-oB-------?--------?------E--?--X--o--M--E--o---o?M----------E-?------B----E-?o-E?-----o--?-----oo-----E----XEX--EMo---M-B------B-----?o-------o--X----
-----o-E-M-----------E-X------M?--XM------B----BMME------?--o-XBX------M-?----BM-X-M-EB?BM-EX-E-X?-------BM--oB--XBEX-o---?-o------o--B-X-----X--B-?--------------?-----E--E--E---?----------XXEEX-B----
------E--o----o?-oo----o--X?--?---B--X-M?-B--oEB--------o-Eo---M-o---Eo-----------------M-MX----E?-------E---?BXB-?--?----B------M----X-M----??X----?--E--o?--o--E--?--o--o-M-E-------?---X---X-B-------
--?-BX----EXXo------X----?-E------o---?-oo--o------?--X--EE-EEB-E-o--o--M--EM--E--M-M--M--Xo-----EM--oM---XM-------M-B-B-X-M?B----------o--o---------X-?---?-M--------B-M-B---MX-?X--B------MX-M---o----
---------?----?--o--X--o?-B--X-E--B--o-M---?--------XM-o---?EE--E--------------E----XB-----o--B---E--------X-?-?B-oB-----Eo-o-M-----B-X?M--oE--X--E-E-B--XM-?Eo-X-----o---M---E--B---?-X-X----o----M-B-v
------E-E---E--E?X-X--E---E--B-----E---M-----?-B-------?-Xo---o--o---E-----B-?M--M-----------M---------B-X----E------B----E--B-?-----E-E-MB--------XE---?---X----?-?------?---------E--?--Bo--o--B-----f
----M--E-MX-----oE---B----X---M-----------------oE--B--E-X?--o--X--B-XE--B------------------B--B?BE--X-B--?Xo------?-BB-B??---?o------BBMX-B-XXBM----E-------X-------X-E-?---XM------X-?--oX---?EEB----f
-----------BMM---M-------E---X?M----EE?M---E-ME--M--o------B---Eo------X----------?----------?--?E-XEX-------o-o--------M-?--E-?o----X-oM--o--M-X----E-E-M---XX--------o--?--?M-MB-----X?-?--------B?-of
------B---o--oB-?---MM--o-----?Mo--------M?-----M-o--E-?----E------E-?---X-?X--B-o-B-----------E--------X--X----MM----------E----EX--o--X-E-X-M----EB--E---o--X-------oB-B---?----B--------B-B---E-----f
----B-o--X-o--?-------------?o--E----MM-------X---X--B-E--------------------o-oM--?---------X--------E---?--X------B------?M-?-M--M-B-o-M-----B--?---------------o-E--?E----X-----?-M-o--------MM--EMB-f
----oM-B-?-E----o---?-M-----------E------B-E-o-o---?------o-?--------EB--?-----o------oo-M----?E---?-B?X-B---o-M---o--M---EB--E-XM--B--B---o--??--o-o---?-?-------X?----X---MEX-X------?--X----o----X-Bf
m----BB-B------??o-T---o--M-TT---T---B-T--E-----?X--B-T-?--M---TB-M--E--?--E------T--o--TX-E----B?--T---T-MM---M-E---M---o-T----X--TB------M-B-------X------ooo-----BMX-BT-M------X-MB--B-M--M--?-?o---X
XXX?XXXXXXXXX?XXXXM|BBXXoXMo||XEX|XXXBX|EXX?BXXXXXXXXX|BMXXXXXX|XXXXXMM?XXoXXXXoXX|XXEE?|oXXX?MXMXXX|XXX|XXXXXXXEXXXXooXXoX|XXXXXXX|oXBXXXXXXBXXE?XXXXBXXXEXXXXXXXMBBXMXX|XXXXM?XXXXXEXMoXME?XXXMB?XXXXX
