---------------------------------------------------------------------------------------------------------------------------------------------------------------------------------------o----------------
--------------------------------------------------------------------------------------------------------------------------------------------------------------------------------------------------------
--------------------------------------------------------------------------------------------------------------------------------------------------------------------------------------------------------
------------------------------------------------------------------------------------------------------------------------------------------------?-------------------------------------------------------
--------------------------------------------------------------------------------------------------------------------------------------------------------------------------------------------------------
-------------------------------------------?--------------------------------------------------------------------------------------M---------------B-----------------------------------------------------
------------------------------BBBBBB--------------------------------------------------------------------------BBB---------------------------------------------------------------------------------------
---------------------------------------------------------------------------------------------------------------------X---------------------------------------------------------------------------------v
--------------------------------------------------------------------------------------------------------------------XX---------------------------------------------------------------------------------f
-----------------------------------------------------------------------------BB------------------------------------XXX---------------------------------------------------------------------------------f
---------------------------------------------------------o--------------------------------------------------------XXXX-------------------------------------X-------------------------------------------f
-----------------------------------------------------------------------------------------------------------------XXXXX--------B---------------------------XX-------------------------------------------f
------------------------BBBBBB----------------------------------------------------------------------------------XXXXXX---B-------------------------------XXX-------------------------------------------f
---------------------------------------------------------------------------------------------------------------XXXXXXX----------------------T-----------XXXX-------------------------------------------f
m-----------------------------------------------E-X--E--------------------------------------------------------XXXXXXXX----------------------|-------o--XXXXX--------------------------------------??---X
XXXXXXXXXXXXXXXXXXXXXXXXXXXXXXXXXXXXXXXXXXXXXXXXXXXXXXXXXXXXXXXXXXXXXXXXXXXXXXXXXXXXXXXXXXXXXXXXXXXXXXXXXXXXXXXXXXXXXXXXXXXXXXXXXXXXXXXXXXXX|XXXXXXXXXXXXXXXXXXXXXXXXXXXXXXXXXXXXXXXXXXXXXXXXXXXXXXXXXXX
