-?----B---XM------B-----M--BX---------Bo-------oM-M-BXo-oE--------o----EEE-M----o----B-----?---MM-X----B----M--M---o-Xo-B--EX-M-B-E?---?----M--E-o--M-o-------M-M---B------M--o-----------o-E-?-?-?-X---
--X---E--o-------X------M---E-o--------M-o--------E-----X---o--B---EX----o---B---E--M-E-----XM--X--E---------E-?-------Mo-E--------o--?-M--?-B--M--B------B--X-o--X--M?---o-------EX---B-----------?----
---------E----XM-o---oX--------?----X--B-o----------B-------X--o-E----?-XE---X-X------X---------o-----o--M--X--B------o?-?EE--?M-------E-E---M------X--------B---------B?-E-----?XXE--------??------o-?-
------XX----XB-EB-----------------M-----B--E--XX-?M---X?-BB-Bo-M-oE?oB--M----M-----Mo--X?-?oXM-----BB--o-o?---------?X?-M--Eo----o-E-M---o-?----M?---X---XoX---M-----M--B------?M----o-----o?--E-M------
------X--B----E--B----E-o---BoX-ooEM----B--E--ME---X------o----X---B------X-X--X---B--B-BE-----B-Eo---------EM-o-----MB-E------?--Eo--?----E---Mo-E------M--?---XX----XE-E--o-B-ME---M-----M-----X------
-E---XBB---B------oXX-X---XE-?---B-----oB-----Mo-Xo-----B-----E------M----X-o----XM---B---M--?Bo-M----------EB--BoE-X---B-----oE------MX--------?X--?----o---B?B-M-X---o---?M--------E-----?---?--------
-?-M---X---M------B-----------?--o?M-oB---o---XE-X-B------?----X--E---o-----X-?-----X--M---B-------X---M-----X-o--oM---------X---M----X?X----?-?-X-B---E---M-M-BM-o---B-MMM-----o------X------M--Xo--MM-
--o?E-B-?-------oo---o-B-oX-----XB-------?--?----E----X-------M-------B-E--M--ME--MX-E-ME--M---?-EM-B-------?o----oBoE--X--?--oE-BB-----oE---------B-B---?------M--X----M---o-----------------M---?-X-?v
---B?-------BM?---?---o----MXE---E--B--?-E---XXM-?M?-o--B----o---?-M--------EE-?MM----?-oE-?M---M------M---ME--M-B--X------ME--o--M-M--E?-X----M---XX-------?M-M----o--------E---XBo--E----B--B--B----of
-E-X-M-------M?----?-E----o---X-M-------E-o--Xoo---?---XB-----?M--?M------?---E--o?-B-------------B--X--M-?----o----X-------?X-oMB--B-?-------X?-----M------B-E--?-M-?---B----X---?----?---?-----------f
-X--B--?-----X----EXX---MB--BMo-oEE-------E--M-o------EBB--oE---M-EM-----E--------XE------o--BE-B----EE-E----X-M-B-------?-?B---B---X?---------o-M--oE-?----BM--MX---Eoo--B----B------Mo-XM-XXB?---M--Bf
----B---o?MB---------E-----XMo?-----E---EX-M-------MB--X---E-----X------------B-BE------E-E----B------------o-XB----X--B-?--EM-----M-----------o--?B-o--------X-----o-X-X-EX-o---M---o-M-X-----X-M-XE--f
--B--M----?-X-E-o--------M??-----?--o----M---E--------E----------X---B-M-?-----E--M---B--M-?---M-----o--?--------M-------E---X--X--o----E----------EX-BMB------B----X-X-B--B-E--o-?E------------------Bf
-E-X--E-o----o-X--------oE-----?-B-Xo-B?o--E--------X-M?MB---oB-MoM----------ME--Mo??E-----M--------E--o--Xo-E-?----E---?--B-------M------o-o-----M---------?--M----?-M-o-BM?XX-E?---E----M----?----oM-f
mB-o--MX------B------oo------------oX-TX-o---ME?o--X-?-o----M------E-oo?----?XE-X---M---?-----------T--E--EX--oM--M--E----X----?---oT--BB-?--E---E-E--M--o-M-B--X--TX---o-?TE--M-X-?M---BM---B----E--X-X
XMXoXXBXXoXXXXXXXXEXooBXXXXXXXXEXXXXBX|XXXXXXXXXXX?XXXXoXXXXEXXMX?XMXXXXXXXX?XXXXXXoXXX?XXXXXXXXXXMX|XXXXXXX?XEX?XX?XXXXMoXXXXXXXXEB|XoX?BXXXXMXoXBXoXXXo?XXXXXXXXX|XXXXX?X|XXXXXX?EBXXXXXXXoXEBXX?XXX?X
